ustacks discarded,sample, population ,Total,cutsite_not_found,low_quality,retained_reads,total_reads_for_sublibrary,prop_sample_per_library,prop_reads_retained_per_sample
yes,CD.BA.DHI.U.1, Baltimore,1374932,0,142,1374790,58844908,0.023365352,0.999896722
yes,CD.BA.DHI.U.4, Baltimore,4130458,0,453,4130005,52632412,0.07847746,0.999890327
yes,CD.BA.DHI.U.5, Baltimore,8653648,0,956,8652692,52632412,0.16441671,0.999889526
yes,LS.BO.I3.U.1, Boston,9242464,0,1093,9241371,65982292,0.140074916,0.999882
yes,LS.LA.CAN.U.2, Los Angeles,11501326,0,1367,11499959,70673672,0.162738481,0.999881144
yes,LS.LA.CAN.U.5, Los Angeles,3214558,0,405,3214153,70673672,0.045484519,0.999874011
yes,LS.LA.CRI.U.1, Los Angeles,10527704,0,1188,10526516,71228912,0.147800994,0.999887155
yes,LS.LA.MAR.U.1, Los Angeles,13091456,0,1555,13089901,71228912,0.183794131,0.99988122
yes,LS.LA.MAR.U.3, Los Angeles,2965576,0,372,2965204,71228912,0.041634442,0.999874561
yes,PA.BA.PSP.M.1, Baltimore,4462654,0,490,4462164,58844908,0.075837556,0.9998902
yes,TO.BA.DHI.U.1, Baltimore,23052370,0,2648,23049722,52632412,0.437988098,0.999885131
yes,TO.BA.DHI.U.3, Baltimore,3451444,0,394,3451050,52632412,0.065576398,0.999885845
yes,TO.BA.DHI.U.4, Baltimore,1719288,0,187,1719101,52632412,0.032665955,0.999891234
no,CD.BA.AA.U.1,Baltimore,6813988,0,760,6813228,64392576,0.105819466,0.999888
no,CD.BA.AA.U.3,Baltimore,2144952,0,225,2144727,64392576,0.033310548,0.999895
no,CD.BA.AA.U.4,Baltimore,51979884,0,6111,51973773,64392576,0.807234113,0.999882
no,CD.BA.CP.U.2,Baltimore,8602708,0,1070,8601638,56969085,0.151006603,0.999876
no,CD.BA.CP.U.4,Baltimore,11910464,0,1406,11909058,56969085,0.209068901,0.999882
no,CD.BA.CP.U.5,Baltimore,26865602,0,3128,26862474,48518859,0.553714629,0.999884
no,CD.BA.DHI.U.1,Baltimore,1374932,0,142,1374790,58844908,0.023365352,0.999896722
no,CD.BA.DHI.U.2,Baltimore,6588590,0,760,6587830,52632412,0.125181229,0.999884649
no,CD.BA.DHI.U.3,Baltimore,1754056,0,219,1753837,52632412,0.033326537,0.999875147
no,CD.BA.DHI.U.4,Baltimore,4130458,0,453,4130005,52632412,0.07847746,0.999890327
no,CD.BA.DHI.U.5,Baltimore,8653648,0,956,8652692,52632412,0.16441671,0.999889526
no,CD.BA.FH.U.1,Baltimore,11212166,0,1352,11210814,49605300,0.226027582,0.999879
no,CD.BA.FH.U.3,Baltimore,12522590,0,1415,12521175,49605300,0.252444598,0.999887
no,CD.BA.FH.U.4,Baltimore,55148150,0,6116,55142034,61261040,0.9002157,0.999889
no,CD.BA.FH.U.5,Baltimore,1722622,0,208,1722414,61261040,0.028119372,0.999879
no,CD.BA.GA.U.1,Baltimore,16810070,0,1890,16808180,75211753,0.223503234,0.999888
no,CD.BA.GA.U.3,Baltimore,18452620,0,2071,18450549,75211753,0.245342241,0.999888
no,CD.BA.GA.U.4,Baltimore,11805778,0,1415,11804363,75211753,0.156967196,0.99988
no,CD.BA.GA.U.5,Baltimore,1932104,0,242,1931862,75211753,0.025688857,0.999875
no,CD.BA.LA.U.1,Baltimore,16224690,0,1875,16222815,51217894,0.316777765,0.999884
no,CD.BA.LA.U.2,Baltimore,12782756,0,1488,12781268,51217894,0.249575978,0.999884
no,CD.BA.LA.U.3,Baltimore,1763132,0,209,1762923,51217894,0.034424141,0.999881
no,CD.BA.LA.U.4,Baltimore,3440808,0,365,3440443,51217894,0.067179802,0.999894
no,CD.BA.LH-2.M.2,Baltimore,28599688,0,3288,28596400,62855778,0.455004916,0.999885
no,CD.BA.LH-2.M.3,Baltimore,25192824,0,2856,25189968,55574200,0.453318698,0.999887
no,CD.BA.LH-2.M.4,Baltimore,21701758,0,2525,21699233,55574200,0.390500592,0.999884
no,CD.BA.LH-2.M.5,Baltimore,5027498,0,583,5026915,55574200,0.090464604,0.999884
no,CD.BA.LL-4.M.1,Baltimore,11020164,0,1305,11018859,48769864,0.225962574,0.999882
no,CD.BA.LL-4.M.2,Baltimore,14445728,0,1678,14444050,48769864,0.296201933,0.999884
no,CD.BA.LL-4.M.4,Baltimore,1283064,0,156,1282908,48769864,0.026308542,0.999878
no,CD.BA.PIK.U.1,Baltimore,2314990,0,247,2314743,92154517,0.025120744,0.999893
no,CD.BA.PIK.U.2,Baltimore,27118626,0,3148,27115478,92154517,0.294273432,0.999884
no,CD.BA.PIK.U.4,Baltimore,15473874,0,1727,15472147,92154517,0.167912268,0.999888
no,CD.BA.PIK.U.5,Baltimore,41612808,0,4829,41607979,92154517,0.45155473,0.999884
no,CD.BA.PSP.M.1,Baltimore,1507472,0,188,1507284,74409858,0.020259036,0.999875
no,CD.BA.PSP.M.4,Baltimore,18105486,0,2094,18103392,74409858,0.243321066,0.999884
no,CD.BA.RG-1.M.1,Baltimore,16858214,0,1937,16856277,56048839,0.30077722,0.999885
no,CD.BA.RG-1.M.2,Baltimore,21411654,0,2456,21409198,56048839,0.382017797,0.999885
no,CD.BA.RG-1.M.4,Baltimore,5897204,0,643,5896561,56048839,0.105215453,0.999891
no,CD.BA.RG-1.M.5,Baltimore,1829934,0,236,1829698,56048839,0.032648919,0.999871
no,CD.BA.TRC.U.1,Baltimore,8106454,0,995,8105459,70999844,0.114175659,0.999877
no,CD.BA.TRC.U.2,Baltimore,6125314,0,728,6124586,70999844,0.086272218,0.999881
no,CD.BA.TRC.U.3,Baltimore,31759460,0,3694,31755766,70999844,0.447317321,0.999884
no,CD.BA.TRC.U.5,Baltimore,3045918,0,392,3045526,70999844,0.042900348,0.999871
no,CD.BA.W3.M.1,Baltimore,10926234,0,1363,10924871,69117528,0.158081956,0.999875
no,CD.BA.W3.M.3,Baltimore,14859394,0,1599,14857795,69117528,0.214987347,0.999892
no,CD.BA.W3.M.4,Baltimore,21379462,0,2543,21376919,69117528,0.309320409,0.999881
no,CD.BA.W3.M.5,Baltimore,1564260,0,223,1564037,69117528,0.022631886,0.999857
no,CD.BA.WB.U.1,Baltimore,5703876,0,671,5703205,64097243,0.088987852,0.999882
no,CD.BA.WB.U.2,Baltimore,11734232,0,1332,11732900,56969085,0.205975434,0.999886
no,CD.BA.WB.U.3,Baltimore,13672320,0,1675,13670645,56969085,0.239995429,0.999877
no,CD.BA.WB.U.4,Baltimore,4010592,0,432,4010160,56969085,0.070399446,0.999892
no,CD.BA.WB.U.5,Baltimore,6538792,0,749,6538043,56969085,0.114777901,0.999885
no,CD.BA.WBO.U.1,Baltimore,2007682,0,255,2007427,75211753,0.026693727,0.999872988
no,CD.BA.WBO.U.2,Baltimore,17061918,0,1989,17059929,75211753,0.226851753,0.999883425
no,CD.BA.WBO.U.3,Baltimore,54977724,0,6320,54971404,74814215,0.734856658,0.999885
no,CD.BA.WBO.U.4,Baltimore,2375324,0,280,2375044,74814215,0.031749635,0.999882
no,CD.BA.WBO.U.5,Baltimore,6592414,0,759,6591655,74814215,0.088117131,0.999885
no,CD.BA.WGP.M.1,Baltimore,1557148,0,202,1556946,70999844,0.02193171,0.99987
no,CD.BA.WGP.M.2,Baltimore,12562866,0,1526,12561340,53535102,0.234665958,0.999879
no,CD.BA.WGP.M.3,Baltimore,10361190,0,1148,10360042,53535102,0.193540119,0.999889
no,CD.BA.WGP.M.4,Baltimore,1917862,0,243,1917619,53535102,0.035824383,0.999873
no,CD.BA.WGP.M.5,Baltimore,21557568,0,2557,21555011,53535102,0.402680992,0.999881
no,CD.LA.ALL.M.1,Los Angeles,2815654,0,305,2815349,54124327,0.052021968,0.999892
no,CD.LA.ALL.M.2,Los Angeles,17890768,0,2059,17888709,53545784,0.334120946,0.999885
no,CD.LA.ALL.M.3,Los Angeles,12470578,0,1432,12469146,53545784,0.232895609,0.999885
no,CD.LA.ALL.M.4,Los Angeles,10391262,0,1124,10390138,53545784,0.194063122,0.999892
no,CD.LA.ALL.M.5,Los Angeles,10511512,0,1166,10510346,53545784,0.196308863,0.999889
no,CD.LA.GLO.M.2,Los Angeles,36034732,0,4139,36030593,56119676,0.642105133,0.999885
no,CD.LA.GLO.M.4,Los Angeles,17846466,0,2046,17844420,56119676,0.318007289,0.999885
no,CD.LA.GLO.M.5,Los Angeles,47011506,0,5500,47006006,93470629,0.502954848,0.999883
no,CD.LA.HAR.M.1,Los Angeles,22183156,0,2626,22180530,66574923,0.333205883,0.999882
no,CD.LA.HAR.M.3,Los Angeles,22074168,0,2506,22071662,66574923,0.33156881,0.999886
no,CD.LA.HAR.M.4,Los Angeles,18164950,0,2150,18162800,66574923,0.272849734,0.999882
no,CD.LA.HAR.M.5,Los Angeles,3292548,0,369,3292179,66574923,0.04945628,0.999888
no,CD.LA.KIN.M.1,Los Angeles,24649056,0,2990,24646066,86827234,0.283886229,0.999878697
no,CD.LA.KIN.M.2,Los Angeles,17196504,0,2027,17194477,54258268,0.316937946,0.999882
no,CD.LA.KIN.M.3,Los Angeles,14076346,0,1603,14074743,54258268,0.259432277,0.999886
no,CD.LA.KIN.M.4,Los Angeles,4572038,0,485,4571553,54258268,0.084264356,0.999894
no,CD.LA.KIN.M.5,Los Angeles,7718436,0,908,7717528,54258268,0.142253638,0.999882
no,CD.LA.LUB.M.2,Los Angeles,1464244,0,147,1464097,57121254,0.025633961,0.9999
no,CD.LA.LUB.M.3,Los Angeles,33249860,0,3970,33245890,57121254,0.582092613,0.999881
no,CD.LA.LUB.M.5,Los Angeles,19915626,0,2263,19913363,57121254,0.348655266,0.999886
no,CD.LA.MR2.M.1,Los Angeles,8559522,0,1009,8558513,55766489,0.15348863,0.999882
no,CD.LA.MR2.M.2,Los Angeles,20839650,0,2332,20837318,55766489,0.373694855,0.999888
no,CD.LA.MR2.M.3,Los Angeles,2766370,0,319,2766051,55766489,0.049606315,0.999885
no,CD.LA.MR2.M.4,Los Angeles,8104754,0,843,8103911,55766489,0.145333768,0.999896
no,CD.LA.MR2.M.5,Los Angeles,14797562,0,1686,14795876,55766489,0.26534864,0.999886
no,CD.LA.NWH.M.1,Los Angeles,5277860,0,669,5277191,85384472,0.061812879,0.999873
no,CD.LA.NWH.M.2,Los Angeles,11727686,0,1392,11726294,85384472,0.137351508,0.999881307
no,CD.LA.NWH.M.3,Los Angeles,3401886,0,376,3401510,85384472,0.039841975,0.999889473
no,CD.LA.NWH.M.4,Los Angeles,23306708,0,2504,23304204,85384472,0.272961903,0.999892563
no,CD.LA.NWH.M.5,Los Angeles,1439170,0,142,1439028,86827234,0.016575099,0.999901
no,CD.LA.ROS.M.1,Los Angeles,6587810,0,742,6587068,50491376,0.130473965,0.999887
no,CD.LA.ROS.M.3,Los Angeles,3608882,0,413,3608469,50491376,0.071475216,0.999886
no,CD.LA.ROS.M.5,Los Angeles,7429582,0,807,7428775,50491376,0.147145564,0.999891
no,CD.LA.SEP.M.1,Los Angeles,3140492,0,369,3140123,59160971,0.053083848,0.999883
no,CD.LA.SEP.M.2,Los Angeles,3902220,0,408,3901812,59160971,0.065959364,0.999895
no,CD.LA.SEP.M.3,Los Angeles,19027452,0,2160,19025292,50491376,0.376845583,0.999886
no,CD.LA.SEP.M.4,Los Angeles,11966406,0,1369,11965037,50491376,0.236999008,0.999886
no,CD.LA.SEP.M.5,Los Angeles,1163310,0,143,1163167,50491376,0.023039776,0.999877
no,CD.LA.VAL.M.2,Los Angeles,17480122,0,1988,17478134,41635282,0.419839164,0.999886
no,CD.LA.VAL.M.3,Los Angeles,9392634,0,1120,9391514,41635282,0.22559314,0.999881
no,CD.LA.VAL.M.4,Los Angeles,2675636,0,307,2675329,41635282,0.064263669,0.999885
no,CD.LA.VAL.M.5,Los Angeles,11146084,0,1269,11144815,41635282,0.267707662,0.999886
no,CD.LA.WHI.M.1,Los Angeles,26177698,0,3155,26174543,59160971,0.442482562,0.999879
no,CD.LA.WHI.M.2,Los Angeles,2852212,0,301,2851911,59160971,0.048211041,0.999894
no,CD.LA.WHI.M.3,Los Angeles,19692674,0,2219,19690455,59160971,0.33286597,0.999887
no,CD.LA.ZOO.M.2,Los Angeles,37103426,0,4241,37099185,86717338,0.427866294,0.999885698
no,CD.LA.ZOO.M.3,Los Angeles,17426180,0,2018,17424162,85384472,0.204090739,0.999884
no,CD.LA.ZOO.M.5,Los Angeles,5140588,0,605,5139983,85384472,0.060205186,0.999882
no,CD.PX.ALA.M.1,Phoenix,4658504,0,495,4658009,51106463,0.091152933,0.999894
no,CD.PX.ALA.M.2,Phoenix,7895476,0,887,7894589,51106463,0.154490754,0.999888
no,CD.PX.ALA.M.4,Phoenix,6339340,0,820,6338520,51106463,0.124041846,0.999871
no,CD.PX.ASH.U.1,Phoenix,8804130,0,1119,8803011,53470550,0.164653814,0.999872901
no,CD.PX.ASH.U.3,Phoenix,10693662,0,1210,10692452,53470550,0.199991622,0.999886849
no,CD.PX.ASH.U.4,Phoenix,2788504,0,306,2788198,69102464,0.040353178,0.99989
no,CD.PX.ASH.U.5,Phoenix,47750172,0,5545,47744627,69102464,0.691005345,0.999884
no,CD.PX.ASU.M.1,Phoenix,35774908,0,4050,35770858,87303263,0.409777444,0.999887
no,CD.PX.ASU.M.2,Phoenix,1077532,0,119,1077413,87303263,0.012342402,0.99989
no,CD.PX.ASU.M.3,Phoenix,9245222,0,1100,9244122,87303263,0.105897783,0.999881
no,CD.PX.ASU.M.4,Phoenix,1629454,0,191,1629263,87303263,0.018664297,0.999883
no,CD.PX.ASU.M.5,Phoenix,17606502,0,2016,17604486,64562580,0.272704437,0.999885
no,CD.PX.BUF.M.1,Phoenix,23699286,0,2604,23696682,128621666,0.184255785,0.999890123
no,CD.PX.BUF.M.2,Phoenix,1481978,0,168,1481810,86112066,0.017209876,0.999887
no,CD.PX.BUF.M.3,Phoenix,18996266,0,2194,18994072,86112066,0.220599352,0.999885
no,CD.PX.BUF.M.5,Phoenix,16345712,0,1868,16343844,86112066,0.189819067,0.999886
no,CD.PX.CAM.U.1,Phoenix,12976630,0,1621,12975009,53470550,0.242687423,0.999875
no,CD.PX.CAM.U.3,Phoenix,5081690,0,556,5081134,53470550,0.095037175,0.999891
no,CD.PX.CAM.U.5,Phoenix,13469296,0,1506,13467790,53470550,0.251901205,0.999888
no,CD.PX.CLA.M.1,Phoenix,11240502,0,1337,11239165,47689595,0.235701352,0.999881
no,CD.PX.CLA.M.2,Phoenix,4209814,0,448,4209366,47689595,0.088275315,0.999894
no,CD.PX.CLA.M.3,Phoenix,9079636,0,982,9078654,47689595,0.190390294,0.999892
no,CD.PX.CLA.M.4,Phoenix,14839002,0,1635,14837367,47689595,0.311158063,0.99989
no,CD.PX.COY.M.1,Phoenix,1881712,0,236,1881476,43314724,0.043442779,0.999875
no,CD.PX.COY.M.2,Phoenix,18704594,0,2245,18702349,43314724,0.431829925,0.99988
no,CD.PX.COY.M.4,Phoenix,6876420,0,776,6875644,43314724,0.158754792,0.999887
no,CD.PX.COY.M.5,Phoenix,12526332,0,1533,12524799,43314724,0.289193393,0.999878
no,CD.PX.DF1.M.2,Phoenix,15885010,0,1887,15883123,64562580,0.246040508,0.999881
no,CD.PX.DF1.M.3,Phoenix,23011714,0,2631,23009083,58414898,0.393935705,0.999886
no,CD.PX.DF1.M.4,Phoenix,7685264,0,896,7684368,58414898,0.131563424,0.999883
no,CD.PX.DF1.M.5,Phoenix,9197732,0,1031,9196701,58414898,0.157455244,0.999888
no,CD.PX.ENC.M.1,Phoenix,10437336,0,1199,10436137,55672462,0.187477536,0.999885
no,CD.PX.ENC.M.2,Phoenix,13761798,0,1588,13760210,55672462,0.247192194,0.999885
no,CD.PX.ENC.M.3,Phoenix,23628324,0,2557,23625767,55672462,0.424416725,0.999892
no,CD.PX.ENC.M.5,Phoenix,3719388,0,430,3718958,55672462,0.066808398,0.999884
no,CD.PX.LAP.M.1,Phoenix,17778108,0,1985,17776123,62602478,0.283984094,0.999888
no,CD.PX.LAP.M.3,Phoenix,23251010,0,2665,23248345,62602478,0.371407183,0.999885
no,CD.PX.LAP.M.4,Phoenix,17579726,0,2010,17577716,62602478,0.280815178,0.999886
no,CD.PX.LAP.M.5,Phoenix,1329004,0,179,1328825,62602478,0.021229255,0.999865
no,CD.PX.MAN.M.1,Phoenix,7096974,0,810,7096164,47210086,0.150327496,0.999886
no,CD.PX.MAN.M.2,Phoenix,2002556,0,261,2002295,47210086,0.04241797,0.99987
no,CD.PX.MAN.M.3,Phoenix,3374802,0,350,3374452,47210086,0.071484767,0.999896
no,CD.PX.MAN.M.4,Phoenix,36394266,0,3948,36390318,56290346,0.646545431,0.999892
no,CD.PX.MAN.M.5,Phoenix,11002546,0,1342,11001204,56290346,0.195460621,0.999878
no,CD.PX.MON.U.2,Phoenix,9067868,0,1108,9066760,61483712,0.147484069,0.999878
no,CD.PX.MON.U.4,Phoenix,1037460,0,120,1037340,61483712,0.016873737,0.999884
no,CD.PX.MON.U.5,Phoenix,24697252,0,2718,24694534,61483712,0.401687719,0.99989
no,CD.PX.MTN.M.2,Phoenix,21160208,0,2519,21157689,79528001,0.266072424,0.999881
no,CD.PX.MTN.M.3,Phoenix,17413396,0,1971,17411425,79528001,0.218959307,0.999886811
no,CD.PX.MTN.M.4,Phoenix,1691544,0,196,1691348,79528001,0.021269792,0.99988413
no,CD.PX.MTN.M.5,Phoenix,10771674,0,1231,10770443,79528001,0.135445049,0.999885719
no,CD.PX.NES.U.1,Phoenix,9915658,0,1172,9914486,55892731,0.177405144,0.999882
no,CD.PX.NES.U.2,Phoenix,11425110,0,1258,11423852,55892731,0.204411375,0.99989
no,CD.PX.NES.U.3,Phoenix,3677564,0,395,3677169,55892731,0.065796821,0.999893
no,CD.PX.NES.U.4,Phoenix,11529624,0,1294,11528330,55892731,0.206281278,0.999888
no,CD.PX.NES.U.5,Phoenix,16041564,0,1754,16039810,55892731,0.287006266,0.999891
no,CD.PX.NET.U.2,Phoenix,2433590,0,234,2433356,43314724,0.056183897,0.999904
no,CD.PX.NET.U.4,Phoenix,28962680,0,3219,28959461,73000716,0.39674515,0.999889
no,CD.PX.NUE.M.2,Phoenix,2788468,0,289,2788179,56017175,0.049778804,0.999896
no,CD.PX.NUE.M.5,Phoenix,44400036,0,5328,44394708,56017175,0.792614694,0.99988
no,CD.PX.PAL.M.1,Phoenix,20070676,0,2228,20068448,64439056,0.311467567,0.999889
no,CD.PX.PAL.M.3,Phoenix,29676044,0,3470,29672574,64439056,0.460528844,0.999883
no,CD.PX.PAL.M.4,Phoenix,20352176,0,2287,20349889,69863464,0.291313583,0.999888
no,CD.PX.PAL.M.5,Phoenix,35135416,0,4121,35131295,69863464,0.502915458,0.999883
no,CD.PX.PKW.U.2,Phoenix,22007158,0,2476,22004682,61483712,0.357934765,0.999887
no,CD.PX.PKW.U.3,Phoenix,30315504,0,3461,30312043,64463929,0.470270808,0.999886
no,CD.PX.PKW.U.4,Phoenix,20686902,0,2342,20684560,64463929,0.320906627,0.999887
no,CD.PX.PKW.U.5,Phoenix,8950366,0,1033,8949333,64463929,0.138843011,0.999885
no,CD.PX.PSC.M.1,Phoenix,17916194,0,2026,17914168,59017095,0.303576345,0.999887
no,CD.PX.PSC.M.3,Phoenix,11033676,0,1244,11032432,59017095,0.186957288,0.999887
no,CD.PX.PSC.M.5,Phoenix,26527024,0,3108,26523916,59017095,0.449480341,0.999883
no,CD.PX.RPC.M.1,Phoenix,25380492,0,2842,25377650,73000716,0.347674563,0.999888
no,CD.PX.RPC.M.3,Phoenix,16279864,0,1925,16277939,73000716,0.223009648,0.999882
no,CD.PX.RPC.M.4,Phoenix,2302094,0,242,2301852,64970729,0.035432787,0.999895
no,CD.PX.RPC.M.5,Phoenix,53308826,0,5945,53302881,64970729,0.820505277,0.999888
no,CD.PX.RRT.U.2,Phoenix,2282868,0,272,2282596,55892731,0.040843737,0.999881
no,CD.PX.RRT.U.4,Phoenix,13437440,0,1521,13435919,51106463,0.262930346,0.999887
no,CD.PX.RRT.U.5,Phoenix,17462366,0,2221,17460145,51106463,0.34168606,0.999873
no,CD.PX.WES.M.1,Phoenix,19375632,0,2241,19373391,55110467,0.351578077,0.999884
no,CD.PX.WES.M.3,Phoenix,26284872,0,3104,26281768,55110467,0.476948816,0.999882
no,CD.PX.WES.M.4,Phoenix,9700770,0,1167,9699603,54524524,0.177915721,0.99988
no,CD.PX.WES.M.5,Phoenix,11862328,0,1294,11861034,54524524,0.217559497,0.999891
no,DS.BA.AA.U.1,Baltimore,1100606,0,113,1100493,59659439,0.018448145,0.999897
no,DS.BA.AA.U.2,Baltimore,22949336,0,2649,22946687,59659439,0.38467234,0.999885
no,DS.BA.AA.U.4,Baltimore,20462518,0,2283,20460235,59659439,0.342988777,0.999888
no,DS.BA.CP.U.2,Baltimore,3956386,0,482,3955904,70641788,0.056006312,0.999878
no,DS.BA.CP.U.5,Baltimore,15499630,0,1832,15497798,70641788,0.219411632,0.999882
no,DS.BA.DHI.U.1,Baltimore,16877042,0,1890,16875152,80804625,0.208862327,0.999888
no,DS.BA.DHI.U.3,Baltimore,14970684,0,1655,14969029,80804625,0.185270138,0.999889
no,DS.BA.DHI.U.4,Baltimore,12912722,0,1448,12911274,80804625,0.159801769,0.999888
no,DS.BA.DHI.U.5,Baltimore,4780250,0,512,4779738,80804625,0.059158124,0.999892893
no,DS.BA.GA.U.1,Baltimore,3005008,0,370,3004638,80804625,0.037188564,0.999876872
no,DS.BA.GA.U.2,Baltimore,13774542,0,1567,13772975,80804625,0.170467247,0.999886239
no,DS.BA.GA.U.3,Baltimore,2303900,0,236,2303664,83932483,0.027449444,0.999898
no,DS.BA.GA.U.4,Baltimore,13926862,0,1671,13925191,83932483,0.165929346,0.99988
no,DS.BA.LA.U.1,Baltimore,5473726,0,644,5473082,68321352,0.080117355,0.999882347
no,DS.BA.LA.U.2,Baltimore,2717286,0,300,2716986,68321352,0.039772134,0.999889596
no,DS.BA.LA.U.3,Baltimore,8910864,0,1014,8909850,68321352,0.130425756,0.999886206
no,DS.BA.LA.U.5,Baltimore,14806460,0,1807,14804653,56357888,0.262722052,0.999878
no,DS.BA.LH-1.M.1,Baltimore,1669548,0,179,1669369,83932483,0.01989156,0.999893
no,DS.BA.LH-1.M.2,Baltimore,9914560,0,1139,9913421,83932483,0.118125422,0.999885
no,DS.BA.LH-1.M.4,Baltimore,4546558,0,534,4546024,83932483,0.05416923,0.999883
no,DS.BA.LH-2.M.1,Baltimore,10766270,0,1152,10765118,68321352,0.157582801,0.999893
no,DS.BA.LH-2.M.3,Baltimore,5878388,0,718,5877670,68321352,0.086040276,0.999878
no,DS.BA.LH-2.M.5,Baltimore,9570254,0,1117,9569137,68321352,0.140077058,0.999883
no,DS.BA.LH-3.M.1,Baltimore,18098564,0,2076,18096488,83932483,0.215632415,0.999885
no,DS.BA.LH-3.M.2,Baltimore,8570544,0,974,8569570,83932483,0.102112361,0.999886355
no,DS.BA.LH-3.M.3,Baltimore,4487720,0,526,4487194,83932483,0.053468214,0.999882791
no,DS.BA.LH-3.M.4,Baltimore,19086516,0,2117,19084399,83932483,0.227403209,0.999889084
no,DS.BA.LH-3.M.5,Baltimore,10372814,0,1203,10371611,70641788,0.146836799,0.999884
no,DS.BA.LL-3.M.1,Baltimore,7255214,0,821,7254393,56164590,0.129177726,0.999887
no,DS.BA.LL-3.M.3,Baltimore,19862398,0,2165,19860233,61903222,0.320862103,0.999891
no,DS.BA.LL-4.M.1,Baltimore,13732834,0,1605,13731229,70641788,0.194400997,0.999883127
no,DS.BA.LL-4.M.3,Baltimore,11548438,0,1320,11547118,68321352,0.169031169,0.999886
no,DS.BA.LL-4.M.5,Baltimore,11392608,0,1299,11391309,68321352,0.16675033,0.999886
no,DS.BA.PIK.U.1,Baltimore,10448848,0,1164,10447684,80804625,0.129310024,0.999889
no,DS.BA.PIK.U.3,Baltimore,2390512,0,251,2390261,80804625,0.029583851,0.999895
no,DS.BA.PSP.M.2,Baltimore,2910660,0,340,2910320,61903222,0.047019523,0.999883
no,DS.BA.PSP.M.5,Baltimore,20083534,0,2370,20081164,61903222,0.324434389,0.999882
no,DS.BA.RG-1.M.1,Baltimore,19248106,0,2147,19245959,56164590,0.34270892,0.999888
no,DS.BA.RG-1.M.3,Baltimore,22102750,0,2610,22100140,56164590,0.393535322,0.999882
no,DS.BA.RG-1.M.4,Baltimore,5250582,0,609,5249973,56164590,0.093485629,0.999884
no,DS.BA.RG-2.M.2,Baltimore,17062210,0,1965,17060245,61903222,0.275627172,0.999885
no,DS.BA.RG-2.M.3,Baltimore,9833260,0,1091,9832169,48769864,0.201625742,0.999889
no,DS.BA.RG-2.M.4,Baltimore,9885368,0,1137,9884231,48769864,0.202694188,0.999885
no,DS.BA.RG-2.M.5,Baltimore,1636940,0,164,1636776,48769864,0.03356458,0.9999
no,DS.BA.TRC.U.2,Baltimore,15745158,0,1734,15743424,56357888,0.27937807,0.99989
no,DS.BA.TRC.U.3,Baltimore,17327532,0,1993,17325539,56357888,0.307455311,0.999885
no,DS.BA.TRC.U.4,Baltimore,1164554,0,139,1164415,56357888,0.020663549,0.999881
no,DS.BA.TRC.U.5,Baltimore,5951948,0,621,5951327,56357888,0.105609848,0.999896
no,DS.BA.W3.M.2,Baltimore,10436146,0,1259,10434887,59659439,0.174928665,0.999879
no,DS.BA.W3.M.3,Baltimore,1046912,0,107,1046805,59659439,0.017548137,0.999898
no,DS.BA.W3.M.4,Baltimore,2935606,0,332,2935274,59659439,0.049206061,0.999887
no,DS.BA.WB.U.2,Baltimore,12482700,0,1529,12481171,70641788,0.176704191,0.999878
no,DS.BA.WB.U.3,Baltimore,4699362,0,546,4698816,70641788,0.066523826,0.999884
no,DS.BA.WB.U.4,Baltimore,6456022,0,790,6455232,70641788,0.091390977,0.999877634
no,DS.BA.WB.U.5,Baltimore,2040792,0,193,2040599,70641788,0.028889303,0.999905429
no,DS.BO.HC1.M.1,Boston,3779864,0,441,3779423,65309760,0.057875944,0.999883
no,DS.BO.HC1.M.2,Boston,7585188,0,836,7584352,65309760,0.116141722,0.99989
no,DS.BO.HC1.M.3,Boston,7984018,0,931,7983087,65309760,0.122248466,0.999883
no,DS.BO.HC1.M.5,Boston,1612036,0,171,1611865,65309760,0.024682926,0.999894
no,DS.BO.HC2.M.2,Boston,15987310,0,1814,15985496,61537140,0.259799367,0.999887
no,DS.BO.HC2.M.3,Boston,9457254,0,1152,9456102,61537140,0.153683678,0.999878
no,DS.BO.HC2.M.4,Boston,3871306,0,435,3870871,61537140,0.062910073,0.999888
no,DS.BO.HC2.M.5,Boston,13933088,0,1593,13931495,61537140,0.226417542,0.999886
no,DS.BO.HC4.M.1,Boston,14523056,0,1666,14521390,61537140,0.236004728,0.999885
no,DS.BO.HC4.M.3,Boston,1728234,0,204,1728030,61537140,0.028084406,0.999882
no,DS.BO.HC4.M.4,Boston,1642976,0,189,1642787,61537140,0.026698933,0.999885
no,DS.BO.HC4.M.5,Boston,10754766,0,1295,10753471,56250626,0.191193712,0.99988
no,DS.BO.I1.U.3,Boston,12824844,0,1577,12823267,122750254,0.104479165,0.999877
no,DS.BO.I2.U.1,Boston,17620822,0,2023,17618799,122750254,0.143550188,0.999885
no,DS.BO.I4.U.1,Boston,19247800,0,2200,19245600,122750254,0.156804564,0.999886
no,DS.BO.I4.U.3,Boston,9490102,0,1127,9488975,122750254,0.07731228,0.999881
no,DS.BO.I4.U.4,Boston,1734654,0,207,1734447,122750254,0.014131572,0.999881
no,DS.BO.I4.U.5,Boston,19184044,0,2121,19181923,122750254,0.156285167,0.999889
no,DS.BO.LC1.M.1,Boston,7379840,0,808,7379032,56250626,0.131195695,0.999891
no,DS.BO.LC1.M.2,Boston,1380544,0,159,1380385,56250626,0.024542731,0.999885
no,DS.BO.LC1.M.3,Boston,11647780,0,1371,11646409,56250626,0.20706934,0.999882
no,DS.BO.LC1.M.5,Boston,10072270,0,1065,10071205,56250626,0.179060585,0.999894
no,DS.BO.LC2.M.2,Boston,14442656,0,1636,14441020,56250626,0.256755471,0.999887
no,DS.BO.LC2.M.3,Boston,20376364,0,2124,20374240,53940046,0.377759485,0.999896
no,DS.BO.LC2.M.5,Boston,3042672,0,311,3042361,53940046,0.056408406,0.999898
no,DS.BO.LC3.M.5,Boston,13444590,0,1618,13442972,53940046,0.249250622,0.99988
no,DS.BO.LC4.M.2,Boston,14740486,0,1720,14738766,53940046,0.273275369,0.999883
no,DS.BO.LC4.M.4,Boston,27518354,0,3103,27515251,57204653,0.481050973,0.999887
no,DS.BO.R1.U.1,Boston,16431210,0,1854,16429356,122750254,0.133858868,0.999887166
no,DS.BO.R1.U.2,Boston,1312022,0,135,1311887,122750254,0.010688548,0.999897105
no,DS.BO.R1.U.3,Boston,23486222,0,2811,23483411,122750254,0.191333388,0.999880313
no,DS.BO.R1.U.4,Boston,10831170,0,1220,10829950,79125897,0.136885273,0.999887
no,DS.BO.R2.U.1,Boston,15105546,0,1774,15103772,79125897,0.19090521,0.999883
no,DS.BO.R2.U.2,Boston,16022376,0,1847,16020529,79125897,0.202492188,0.999885
no,DS.BO.R2.U.3,Boston,8291530,0,956,8290574,79125897,0.104789081,0.999884702
no,DS.BO.R2.U.5,Boston,12869914,0,1544,12868370,79125897,0.162651098,0.99988003
no,DS.BO.R3.U.1,Boston,2065320,0,217,2065103,79125897,0.026101695,0.999895
no,DS.BO.R3.U.4,Boston,11192048,0,1279,11190769,79125897,0.141446081,0.999886
no,DS.BO.R4.U.1,Boston,2618210,0,268,2617942,112390624,0.023295627,0.999898
no,DS.BO.R4.U.2,Boston,37527472,0,4427,37523045,112390624,0.333902159,0.999882
no,DS.BO.R4.U.4,Boston,14365218,0,1659,14363559,112390624,0.127815092,0.999885
no,DS.BO.R4.U.5,Boston,47246584,0,5625,47240959,112390624,0.42037834,0.999881
no,DS.BO.WL1.M.1,Boston,7349122,0,871,7348251,57204653,0.128470703,0.999881
no,DS.BO.WL1.M.2,Boston,16367608,0,1873,16365735,57204653,0.286123718,0.999886
no,DS.BO.WL1.M.4,Boston,3400320,0,359,3399961,57204653,0.059441319,0.999894
no,DS.BO.WL2.M.1,Boston,9841388,0,1256,9840132,38277506,0.257106302,0.999872
no,DS.BO.WL2.M.3,Boston,1662758,0,186,1662572,38277506,0.04343956,0.999888
no,DS.BO.WL3.M.1,Boston,14862824,0,1798,14861026,38277506,0.388291337,0.999879
no,DS.BO.WL3.M.3,Boston,10672752,0,1224,10671528,38277506,0.278825689,0.999885
no,DS.BO.WL3.M.4,Boston,1454978,0,204,1454774,53104248,0.027398524,0.99986
no,DS.BO.WL3.M.5,Boston,23721562,0,2840,23718722,53104248,0.446698012,0.99988
no,DS.BO.WL4.M.2,Boston,11916306,0,1416,11914890,53104248,0.224394591,0.999881
no,DS.BO.WL4.M.3,Boston,10715740,0,1215,10714525,53104248,0.20178687,0.999887
no,DS.BO.WL4.M.5,Boston,4425818,0,456,4425362,53104248,0.083342071,0.999897
no,DS.MN.L01-DS.M.1,Minneapolis,20938114,0,2400,20935714,61748404,0.339087533,0.999885
no,DS.MN.L01-DS.M.2,Minneapolis,1000160,0,142,1000018,61748404,0.016197342,0.999858
no,DS.MN.L01-DS.M.3,Minneapolis,4252582,0,460,4252122,61748404,0.068869505,0.999892
no,DS.MN.L01-DS.M.5,Minneapolis,31378210,0,3542,31374668,61748404,0.508162284,0.999887
no,DS.MN.L01-DS.U.2,Minneapolis,24925968,0,2759,24923209,66453007,0.375091649,0.999889
no,DS.MN.L01-DS.U.3,Minneapolis,1563474,0,167,1563307,56193011,0.027823282,0.999893
no,DS.MN.L01-DS.U.4,Minneapolis,12041600,0,1373,12040227,56193011,0.214289994,0.999886
no,DS.MN.L02-DS.M.2,Minneapolis,17478504,0,2072,17476432,86910689,0.201108796,0.999881
no,DS.MN.L02-DS.M.4,Minneapolis,12609014,0,1433,12607581,86910689,0.145080129,0.999886
no,DS.MN.L02-DS.M.5,Minneapolis,19393860,0,2298,19391562,86910689,0.223147006,0.999882
no,DS.MN.L02-DS.U.1,Minneapolis,20667450,0,2335,20665115,56193011,0.367793959,0.999887
no,DS.MN.L02-DS.U.2,Minneapolis,16512464,0,1859,16510605,56193011,0.293852629,0.999887
no,DS.MN.L02-DS.U.3,Minneapolis,1151462,0,99,1151363,56193011,0.020491196,0.999914
no,DS.MN.L02-DS.U.4,Minneapolis,3616922,0,407,3616515,56193011,0.064366047,0.999887
no,DS.MN.L03-DS.M.1,Minneapolis,1127266,0,143,1127123,86910689,0.012970395,0.999873
no,DS.MN.L03-DS.M.2,Minneapolis,4038902,0,493,4038409,86910689,0.046471867,0.999878
no,DS.MN.L03-DS.M.4,Minneapolis,10486662,0,1190,10485472,86910689,0.12066021,0.999887
no,DS.MN.L03-DS.M.5,Minneapolis,5830192,0,662,5829530,86910689,0.067082566,0.999886453
no,DS.MN.L03-DS.U.1,Minneapolis,7882006,0,862,7881144,54014969,0.145922624,0.999891
no,DS.MN.L03-DS.U.2,Minneapolis,6851520,0,821,6850699,54014969,0.126844838,0.99988
no,DS.MN.L03-DS.U.3,Minneapolis,4087206,0,474,4086732,54014969,0.075668025,0.999884
no,DS.MN.L03-DS.U.4,Minneapolis,10431280,0,1291,10429989,54014969,0.193118319,0.999876
no,DS.MN.L03-DS.U.5,Minneapolis,22210824,0,2588,22208236,54014969,0.41119757,0.999883
no,DS.MN.L04-DS.M.1,Minneapolis,1205004,0,134,1204870,86910689,0.013864854,0.999888797
no,DS.MN.L04-DS.M.2,Minneapolis,13049488,0,1521,13047967,86910689,0.150148252,0.999883444
no,DS.MN.L04-DS.M.3,Minneapolis,7680444,0,749,7679695,61370489,0.125148815,0.999902
no,DS.MN.L04-DS.M.5,Minneapolis,1691230,0,203,1691027,61370489,0.027557708,0.99988
no,DS.MN.L04-DS.U.2,Minneapolis,1423678,0,156,1423522,54014969,0.026357101,0.99989
no,DS.MN.L04-DS.U.4,Minneapolis,7687446,0,872,7686574,51124212,0.15036801,0.999887
no,DS.MN.L04-DS.U.5,Minneapolis,10017956,0,1162,10016794,51124212,0.19595326,0.999884
no,DS.MN.L05-DS.M.3,Minneapolis,10457704,0,1131,10456573,61370489,0.170402814,0.999892
no,DS.MN.L05-DS.M.5,Minneapolis,10069026,0,1111,10067915,61370489,0.164069509,0.99989
no,DS.MN.L05-DS.U.1,Minneapolis,4116436,0,445,4115991,51124212,0.080518327,0.999892
no,DS.MN.L05-DS.U.2,Minneapolis,13162272,0,1585,13160687,51124212,0.257456721,0.99988
no,DS.MN.L05-DS.U.4,Minneapolis,8763876,0,1018,8762858,51124212,0.1714232,0.999884
no,DS.MN.L06-DS.M.1,Minneapolis,11378142,0,1265,11376877,61370489,0.185400869,0.999889
no,DS.MN.L06-DS.M.2,Minneapolis,5185554,0,630,5184924,61370489,0.084495889,0.999878509
no,DS.MN.L06-DS.M.4,Minneapolis,13113256,0,1508,13111748,61370489,0.213673644,0.999885002
no,DS.MN.L06-DS.U.1,Minneapolis,6540550,0,731,6539819,51124212,0.12793449,0.999888
no,DS.MN.L06-DS.U.2,Minneapolis,10523240,0,1111,10522129,49214570,0.213823671,0.999894
no,DS.MN.L06-DS.U.3,Minneapolis,9004480,0,1036,9003444,49214570,0.182963704,0.999885
no,DS.MN.L06-DS.U.4,Minneapolis,2177426,0,292,2177134,49214570,0.044243524,0.999866
no,DS.MN.L06-DS.U.5,Minneapolis,6652126,0,810,6651316,49214570,0.135165785,0.999878
no,DS.MN.L07-DS.M.1,Minneapolis,14733656,0,1774,14731882,87012209,0.169328605,0.99988
no,DS.MN.L07-DS.M.3,Minneapolis,11951152,0,1400,11949752,87012209,0.137350288,0.999883
no,DS.MN.L07-DS.M.4,Minneapolis,16823842,0,1920,16821922,87012209,0.193350361,0.999886
no,DS.MN.L07-DS.U.1,Minneapolis,17982794,0,2051,17980743,49214570,0.365395735,0.999886
no,DS.MN.L07-DS.U.3,Minneapolis,1897708,0,206,1897502,49214570,0.038559882,0.999891
no,DS.MN.L07-DS.U.5,Minneapolis,15782110,0,1738,15780372,51729989,0.305086282,0.99989
no,DS.MN.L08-DS.M.2,Minneapolis,7608870,0,824,7608046,87012209,0.087446004,0.999892
no,DS.MN.L08-DS.M.4,Minneapolis,13616084,0,1482,13614602,87012209,0.156484753,0.999891
no,DS.MN.L08-DS.M.5,Minneapolis,5771790,0,701,5771089,87012209,0.066333105,0.999878547
no,DS.MN.L08-DS.U.1,Minneapolis,12430090,0,1462,12428628,51729989,0.240287892,0.999882
no,DS.MN.L08-DS.U.2,Minneapolis,4308804,0,517,4308287,51729989,0.083294122,0.99988
no,DS.MN.L08-DS.U.3,Minneapolis,3233316,0,351,3232965,51729989,0.062503706,0.999891
no,DS.MN.L08-DS.U.5,Minneapolis,5457382,0,655,5456727,51729989,0.105497451,0.99988
no,DS.MN.L09-DS.M.1,Minneapolis,1424800,0,160,1424640,87012209,0.016374714,0.999887704
no,DS.MN.L09-DS.M.2,Minneapolis,13461704,0,1571,13460133,87012209,0.154710519,0.999883299
no,DS.MN.L09-DS.M.3,Minneapolis,12688912,0,1312,12687600,81590747,0.155519008,0.999897
no,DS.MN.L09-DS.M.5,Minneapolis,1843930,0,204,1843726,81590747,0.022599744,0.999889
no,DS.MN.L09-DS.U.2,Minneapolis,10163892,0,1140,10162752,51729989,0.196479686,0.999888
no,DS.MN.L09-DS.U.3,Minneapolis,11876318,0,1416,11874902,49423598,0.240296508,0.999881
no,DS.MN.L09-DS.U.4,Minneapolis,9892706,0,1089,9891617,49423598,0.200161591,0.99989
no,DS.MN.L09-DS.U.5,Minneapolis,4249256,0,533,4248723,49423598,0.085976258,0.999875
no,DS.MN.L10-DS.M.3,Minneapolis,6818118,0,803,6817315,81590747,0.083564843,0.999882
no,DS.MN.L10-DS.M.5,Minneapolis,10750262,0,1233,10749029,81590747,0.131758348,0.999885
no,DS.MN.L10-DS.U.1,Minneapolis,8713686,0,945,8712741,49423598,0.176306185,0.999892
no,DS.MN.L10-DS.U.3,Minneapolis,6215524,0,705,6214819,49423598,0.125760249,0.999887
no,DS.MN.L10-DS.U.5,Minneapolis,7967212,0,926,7966286,49423598,0.16120259,0.999884
no,DS.MN.L11-DS.M.1,Minneapolis,20805572,0,2396,20803176,81590747,0.254999161,0.999885
no,DS.MN.L11-DS.M.2,Minneapolis,6978436,0,856,6977580,81590747,0.085529748,0.999877336
no,DS.MN.L11-DS.M.3,Minneapolis,1354714,0,156,1354558,81590747,0.01660377,0.999884847
no,DS.MN.L11-DS.M.4,Minneapolis,18857620,0,2164,18855456,81590747,0.231124493,0.999885245
no,DS.MN.L11-DS.M.5,Minneapolis,21069738,0,2480,21067258,66453007,0.317062221,0.999882
no,DS.MN.L11-DS.U.1,Minneapolis,13872784,0,1617,13871167,54538834,0.254365247,0.999883
no,DS.MN.L11-DS.U.2,Minneapolis,14192432,0,1588,14190844,54538834,0.260226172,0.999888
no,DS.MN.L11-DS.U.3,Minneapolis,5191198,0,618,5190580,54538834,0.095183516,0.999881
no,DS.MN.L11-DS.U.4,Minneapolis,7574788,0,912,7573876,54538834,0.138887971,0.99988
no,DS.MN.L11-DS.U.5,Minneapolis,12124934,0,1370,12123564,54538834,0.222317441,0.999887
no,DS.MN.L12-DS.M.2,Minneapolis,2713830,0,296,2713534,66453007,0.040838333,0.999891
no,DS.MN.L12-DS.M.5,Minneapolis,15758068,0,1879,15756189,66453007,0.237131,0.999881
no,DS.PX.ALA.M.1,Phoenix,3944218,0,453,3943765,64439056,0.061208501,0.999885
no,DS.PX.BUF.M.1,Phoenix,27322034,0,3166,27318868,86112066,0.317284618,0.999884
no,DS.PX.CLA.M.1,Phoenix,7197676,0,808,7196868,47689595,0.150927598,0.999888
no,DS.PX.DF1.M.1,Phoenix,27831660,0,3140,27828520,57477616,0.484217369,0.999887
no,DS.PX.DF2.M.1,Phoenix,11924760,0,1343,11923417,57477616,0.207467895,0.999887
no,DS.PX.DF2.M.2,Phoenix,1737968,0,209,1737759,57477616,0.030237301,0.99988
no,DS.PX.DF2.M.3,Phoenix,12799450,0,1500,12797950,57477616,0.222685819,0.999883
no,DS.PX.DOW.M.1,Phoenix,21663000,0,2555,21660445,65166517,0.332425316,0.999882
no,DS.PX.DOW.M.2,Phoenix,33874910,0,3916,33870994,65166517,0.519820785,0.999884
no,DS.PX.DOW.M.3,Phoenix,1688108,0,185,1687923,65166517,0.02590453,0.99989
no,DS.PX.DOW.M.4,Phoenix,3166734,0,345,3166389,65166517,0.048594495,0.999891
no,DS.PX.DOW.M.5,Phoenix,1489566,0,169,1489397,65166517,0.022857843,0.999887
no,DS.PX.ENC.M.1,Phoenix,19928628,0,2378,19926250,58191043,0.342468995,0.999881
no,DS.PX.ENC.M.2,Phoenix,4377754,0,502,4377252,58191043,0.075230719,0.999885
no,DS.PX.ENC.M.3,Phoenix,9912094,0,1126,9910968,58191043,0.170337108,0.999886
no,DS.PX.ENC.M.4,Phoenix,2091890,0,227,2091663,58191043,0.03594866,0.999891
no,DS.PX.ENC.M.5,Phoenix,18235972,0,2176,18233796,58191043,0.313381082,0.999881
no,DS.PX.LAP.M.1,Phoenix,15240734,0,1725,15239009,60904779,0.250238721,0.999887
no,DS.PX.LAP.M.2,Phoenix,2145836,0,266,2145570,60904779,0.035232637,0.999876
no,DS.PX.LAP.M.3,Phoenix,15823598,0,1837,15821761,60904779,0.259808807,0.999884
no,DS.PX.LAP.M.5,Phoenix,20231144,0,2353,20228791,60904779,0.332176626,0.999884
no,DS.PX.LAP.M.6,Phoenix,32670596,0,3695,32666901,57423880,0.568937453,0.999887
no,DS.PX.MTN.M.2,Phoenix,2809604,0,310,2809294,71065601,0.039535358,0.99989
no,DS.PX.MTN.M.4,Phoenix,20099676,0,2302,20097374,71065601,0.282832703,0.999885
no,DS.PX.MTN.M.5,Phoenix,1708900,0,176,1708724,79528001,0.021488029,0.999897
no,DS.PX.MTN.M.6,Phoenix,11639188,0,1299,11637889,79528001,0.146353333,0.999888
no,DS.PX.NUE.M.2,Phoenix,7608510,0,870,7607640,56017175,0.135824593,0.999886
no,DS.PX.NUE.M.4,Phoenix,18540734,0,2096,18538638,87303263,0.212371604,0.999887
no,DS.PX.PIE.M.1,Phoenix,17497340,0,2005,17495335,86112066,0.203192663,0.999885411
no,DS.PX.PIE.M.2,Phoenix,17461922,0,2047,17459875,81546899,0.214133489,0.999883
no,DS.PX.PIE.M.3,Phoenix,3181516,0,324,3181192,81546899,0.039014555,0.999898
no,DS.PX.PIE.M.4,Phoenix,6299392,0,735,6298657,81546899,0.077248701,0.999883
no,DS.PX.WES.M.1,Phoenix,3754232,0,405,3753827,54524524,0.068854008,0.999892
no,DS.PX.WES.M.2,Phoenix,11447236,0,1319,11445917,54524524,0.209946555,0.999885
no,DS.PX.WES.M.3,Phoenix,15520942,0,1766,15519176,54524524,0.284659835,0.999886
no,DS.PX.WES.M.5,Phoenix,1203052,0,129,1202923,54524524,0.02206442,0.999893
no,EC.BA.CP.U.2,Baltimore,2339476,0,284,2339192,79298889,0.029502002,0.999879
no,EC.BA.CP.U.4,Baltimore,27976560,0,3160,27973400,79298889,0.35279889,0.999887
no,EC.BA.CP.U.5,Baltimore,9023550,0,1033,9022517,79298889,0.113791632,0.999885522
no,EC.BA.FH.U.1,Baltimore,1177064,0,137,1176927,48518859,0.024259927,0.999884
no,EC.BA.FH.U.2,Baltimore,2194096,0,234,2193862,48518859,0.045221509,0.999893
no,EC.BA.FH.U.3,Baltimore,12951942,0,1476,12950466,69878891,0.185348419,0.999886
no,EC.BA.FH.U.4,Baltimore,19043168,0,2179,19040989,69878891,0.272516746,0.999886
no,EC.BA.FH.U.5,Baltimore,3313582,0,380,3313202,69878891,0.047418927,0.999885
no,EC.BA.GA.U.1,Baltimore,12643848,0,1429,12642419,65406361,0.193312207,0.999887
no,EC.BA.GA.U.2,Baltimore,15522166,0,1796,15520370,65406361,0.237318905,0.999884
no,EC.BA.GA.U.3,Baltimore,1355778,0,149,1355629,65406361,0.020728534,0.99989
no,EC.BA.GA.U.4,Baltimore,1995908,0,221,1995687,65406361,0.030515503,0.999889
no,EC.BA.GA.U.5,Baltimore,3480636,0,394,3480242,65406361,0.053215558,0.999887
no,EC.BA.LH-2.M.1,Baltimore,1321690,0,163,1321527,55574200,0.023782439,0.999877
no,EC.BA.LH-2.M.2,Baltimore,1896050,0,253,1895797,55574200,0.03411745,0.999867
no,EC.BA.LH-3.M.1,Baltimore,3398250,0,393,3397857,74098506,0.045861249,0.999884
no,EC.BA.LH-3.M.5,Baltimore,3849852,0,445,3849407,60920538,0.063194649,0.999884
no,EC.BA.LL-3.M.3,Baltimore,4440600,0,507,4440093,77599742,0.057224417,0.999886
no,EC.BA.LL-3.M.5,Baltimore,1699442,0,189,1699253,77599742,0.021900099,0.999889
no,EC.BA.LL-4.M.1,Baltimore,10809234,0,1255,10807979,62253435,0.173632732,0.999884
no,EC.BA.LL-4.M.2,Baltimore,4200576,0,451,4200125,62253435,0.067475409,0.999893
no,EC.BA.LL-4.M.4,Baltimore,8800798,0,1045,8799753,62253435,0.14137048,0.999881
no,EC.BA.ML.U.1,Baltimore,2948926,0,400,2948526,75211753,0.039208314,0.999864
no,EC.BA.ML.U.3,Baltimore,1719506,0,195,1719311,75211753,0.022862198,0.999887
no,EC.BA.ML.U.4,Baltimore,2102390,0,259,2102131,75211753,0.027952945,0.999876807
no,EC.BA.PIK.U.2,Baltimore,1528608,0,174,1528434,72248024,0.021157783,0.999886
no,EC.BA.PIK.U.3,Baltimore,29950180,0,3668,29946512,72248024,0.414546701,0.999878
no,EC.BA.PIK.U.5,Baltimore,13345806,0,1558,13344248,72248024,0.18472209,0.999883
no,EC.BA.PSP.M.1,Baltimore,1101512,0,120,1101392,72067799,0.015284385,0.999891
no,EC.BA.PSP.M.4,Baltimore,2866808,0,332,2866476,72067799,0.039779319,0.999884
no,EC.BA.PSP.M.5,Baltimore,46237922,0,5379,46232543,72067799,0.641589207,0.999884
no,EC.BA.TRC.U.1,Baltimore,1824368,0,189,1824179,84324103,0.02163519,0.999896
no,EC.BA.TRC.U.2,Baltimore,21943310,0,2447,21940863,84324103,0.260225834,0.999888
no,EC.BA.TRC.U.3,Baltimore,2053744,0,276,2053468,84324103,0.024355361,0.999866
no,EC.BA.TRC.U.4,Baltimore,14849034,0,1769,14847265,84324103,0.176094776,0.999881
no,EC.BA.TRC.U.5,Baltimore,13426978,0,1526,13425452,84324103,0.159230606,0.999886
no,EC.BA.WB.U.1,Baltimore,7907796,0,879,7906917,54931058,0.14395856,0.999889
no,EC.BA.WB.U.3,Baltimore,23293088,0,2598,23290490,54931058,0.424042224,0.999888
no,EC.BA.WB.U.4,Baltimore,25511376,0,2894,25508482,64097243,0.398010504,0.999887
no,EC.BA.WB.U.5,Baltimore,5641652,0,615,5641037,64097243,0.088017077,0.999891
no,EC.BA.WBO.U.4,Baltimore,2354458,0,251,2354207,92154517,0.025549024,0.999893
no,EC.BO.R4.U.1,Boston,8149030,0,920,8148110,67481107,0.120760171,0.999887
no,EC.LA.AC1.U.1,Los Angeles,17181134,0,1944,17179190,69146359,0.248474891,0.999887
no,EC.LA.AC1.U.2,Los Angeles,1028168,0,121,1028047,69146359,0.014869445,0.999882
no,EC.LA.AC1.U.3,Los Angeles,11992384,0,1408,11990976,69146359,0.173434786,0.999883
no,EC.LA.AC1.U.4,Los Angeles,2203000,0,242,2202758,69146359,0.031859957,0.99989
no,EC.LA.AC2.U.1,Los Angeles,22175940,0,2613,22173327,69477119,0.319183356,0.999882
no,EC.LA.AC2.U.2,Los Angeles,20068440,0,2137,20066303,69477119,0.288849628,0.999894
no,EC.LA.AC2.U.4,Los Angeles,6003860,0,700,6003160,69477119,0.086414925,0.999883
no,EC.LA.DUR.U.1,Los Angeles,4999330,0,567,4998763,57205652,0.087392239,0.999887
no,EC.LA.DUR.U.2,Los Angeles,7887286,0,864,7886422,57205652,0.137875992,0.99989
no,EC.LA.DUR.U.4,Los Angeles,6867846,0,714,6867132,57205652,0.120055375,0.999896
no,EC.LA.HOW.U.1,Los Angeles,23753664,0,2603,23751061,57205652,0.415232817,0.99989
no,EC.LA.HOW.U.2,Los Angeles,18015010,0,2043,18012967,65875026,0.27347253,0.999887
no,EC.LA.HOW.U.3,Los Angeles,23221276,0,2733,23218543,65875026,0.352504999,0.999882
no,EC.LA.HOW.U.4,Los Angeles,4218578,0,501,4218077,65875026,0.064039109,0.999881
no,EC.LA.HOW.U.5,Los Angeles,12357940,0,1383,12356557,65875026,0.187596738,0.999888
no,EC.LA.SAN.U.2,Los Angeles,3134854,0,390,3134464,65875026,0.047587898,0.999876
no,EC.LA.SAN.U.4,Los Angeles,3981318,0,447,3980871,65875026,0.060437441,0.999888
no,EC.LA.SAN.U.5,Los Angeles,2948840,0,351,2948489,61109961,0.048254654,0.999881
no,EC.LA.SGB.U.1,Los Angeles,1746094,0,179,1745915,59508219,0.029342064,0.999897
no,EC.LA.SGB.U.2,Los Angeles,15286886,0,1782,15285104,59508219,0.256886969,0.999883
no,EC.LA.SGB.U.3,Los Angeles,5033078,0,582,5032496,59508219,0.084577863,0.999884
no,EC.LA.SGB.U.4,Los Angeles,7543466,0,864,7542602,57205652,0.131865746,0.999885
no,EC.LA.SGB.U.5,Los Angeles,5527642,0,694,5526948,57205652,0.09662755,0.999874
no,EC.LA.SGR.U.2,Los Angeles,9108434,0,1022,9107412,60763308,0.149900233,0.999888
no,EC.LA.SGR.U.3,Los Angeles,16982756,0,2073,16980683,60763308,0.279490313,0.999878
no,EC.LA.SGR.U.4,Los Angeles,2715396,0,284,2715112,60763308,0.044688087,0.999895
no,EC.LA.SGR.U.5,Los Angeles,7917280,0,914,7916366,60763308,0.130297054,0.999885
no,EC.LA.VB1.U.1,Los Angeles,14140936,0,1631,14139305,69146359,0.204507312,0.999885
no,EC.LA.VB1.U.3,Los Angeles,21305704,0,2498,21303206,69146359,0.308124742,0.999883
no,EC.LA.VB1.U.4,Los Angeles,1623880,0,202,1623678,60763308,0.026724681,0.999876
no,EC.LA.VB1.U.5,Los Angeles,21320484,0,2592,21317892,60763308,0.350877605,0.999878
no,EC.LA.VB2.U.1,Los Angeles,2269768,0,256,2269512,61109961,0.037142357,0.999887
no,EC.LA.VB2.U.4,Los Angeles,18729330,0,2161,18727169,69477119,0.269575513,0.999885
no,EC.LA.VER.U.1,Los Angeles,14040284,0,1508,14038776,61109961,0.229754426,0.999893
no,EC.LA.VER.U.2,Los Angeles,7877136,0,937,7876199,61109961,0.128901015,0.999881
no,EC.LA.VER.U.3,Los Angeles,14739386,0,1627,14737759,61109961,0.241194492,0.99989
no,EC.LA.VER.U.4,Los Angeles,17602148,0,1993,17600155,61109961,0.28804057,0.999887
no,EC.PX.ALA.M.2,Phoenix,2117156,0,264,2116892,64439056,0.032855168,0.999875
no,EC.PX.ALA.M.3,Phoenix,2851316,0,326,2850990,64439056,0.044248258,0.999886
no,EC.PX.ALA.M.5,Phoenix,4408906,0,448,4408458,64439056,0.068419779,0.999898
no,EC.PX.BUF.M.1,Phoenix,19924404,0,2246,19922158,128621666,0.154907059,0.999887
no,EC.PX.BUF.M.3,Phoenix,2059398,0,239,2059159,128621666,0.016011284,0.999884
no,EC.PX.BUF.M.6,Phoenix,21675384,0,2459,21672925,128621666,0.168520473,0.999887
no,EC.PX.CLA.M.1,Phoenix,3491774,0,405,3491369,56290346,0.062031489,0.999884
no,EC.PX.COY.M.1,Phoenix,3519956,0,420,3519536,57127677,0.061615598,0.999881
no,EC.PX.COY.M.2,Phoenix,14712572,0,1584,14710988,57127677,0.257538426,0.999892
no,EC.PX.COY.M.3,Phoenix,23396766,0,2518,23394248,57127677,0.409552204,0.999892
no,EC.PX.COY.M.5,Phoenix,3601666,0,433,3601233,57127677,0.063045903,0.99988
no,EC.PX.DF1.M.1,Phoenix,3836226,0,392,3835834,58414898,0.065672048,0.999898
no,EC.PX.DF1.M.2,Phoenix,12696700,0,1489,12695211,58414898,0.217353799,0.999883
no,EC.PX.DOW.M.1,Phoenix,14991448,0,1668,14989780,62869089,0.23845499,0.999889
no,EC.PX.DOW.M.2,Phoenix,16085166,0,1903,16083263,62869089,0.255851743,0.999882
no,EC.PX.DOW.M.3,Phoenix,6618832,0,756,6618076,62869089,0.105279591,0.999886
no,EC.PX.DOW.M.4,Phoenix,19642078,0,2294,19639784,62869089,0.312428227,0.999883
no,EC.PX.MAN.M.1,Phoenix,1477078,0,164,1476914,56290346,0.026240343,0.999889
no,EC.PX.MAN.M.4,Phoenix,2785496,0,322,2785174,56290346,0.049484436,0.999884
no,EC.PX.MTN.M.2,Phoenix,2997832,0,361,2997471,79528001,0.037695302,0.99988
no,EC.PX.MTN.M.3,Phoenix,10278742,0,1169,10277573,79528001,0.12924683,0.999886
no,EC.PX.NUE.M.2,Phoenix,20121454,0,2288,20119166,87303263,0.230477686,0.999886
no,EC.PX.PSC.M.1,Phoenix,1265668,0,177,1265491,62321702,0.020308624,0.99986
no,EC.PX.PSC.M.2,Phoenix,17936328,0,2094,17934234,62321702,0.287802281,0.999883
no,EC.PX.PSC.M.4,Phoenix,35705694,0,3928,35701766,62321702,0.572925528,0.99989
no,EC.PX.WES.M.1,Phoenix,3268876,0,363,3268513,55110467,0.059314976,0.999889
no,EC.PX.WES.M.2,Phoenix,2603202,0,295,2602907,55110467,0.047236072,0.999887
no,EC.PX.WES.M.3,Phoenix,1839926,0,198,1839728,55110467,0.033386144,0.999892
no,EC.PX.WES.M.4,Phoenix,1110162,0,123,1110039,55110467,0.020144304,0.999889
no,LS.BA.CP.U.2,Baltimore,7348334,0,860,7347474,90171417,0.081492941,0.999883
no,LS.BA.CP.U.4,Baltimore,8839378,0,927,8838451,90171417,0.098028603,0.999895
no,LS.BA.CP.U.5,Baltimore,19802894,0,2168,19800726,90171417,0.219613872,0.999891
no,LS.BA.DHI.U.2,Baltimore,1004112,0,106,1004006,61261040,0.016390711,0.999894
no,LS.BA.GA.U.1,Baltimore,8024616,0,936,8023680,55802660,0.143803467,0.999883
no,LS.BA.GA.U.3,Baltimore,4461066,0,514,4460552,55802660,0.079943608,0.999885
no,LS.BA.GA.U.4,Baltimore,23373108,0,2620,23370488,58844908,0.39719848,0.999887905
no,LS.BA.GA.U.5,Baltimore,11834718,0,1413,11833305,58844908,0.201117113,0.999880606
no,LS.BA.ML.U.2,Baltimore,6421124,0,804,6420320,90171417,0.071210193,0.999875
no,LS.BA.ML.U.4,Baltimore,11844818,0,1347,11843471,90171417,0.131358898,0.999886
no,LS.BA.ML.U.5,Baltimore,7595090,0,882,7594208,90171417,0.084229463,0.999883872
no,LS.BA.PIK.U.1,Baltimore,4682250,0,514,4681736,49254844,0.095061716,0.99989
no,LS.BA.PIK.U.2,Baltimore,3973290,0,479,3972811,49254844,0.080668005,0.999879
no,LS.BA.PIK.U.3,Baltimore,5327890,0,618,5327272,49254844,0.108169869,0.999884
no,LS.BA.PIK.U.5,Baltimore,3709492,0,415,3709077,49254844,0.075312227,0.999888
no,LS.BA.PSP.M.1,Baltimore,9755624,0,1152,9754472,72067799,0.135367309,0.999882
no,LS.BA.WB.U.1,Baltimore,1215918,0,122,1215796,64097243,0.018969895,0.9999
no,LS.BA.WB.U.2,Baltimore,6651640,0,776,6650864,64097243,0.103774198,0.999883
no,LS.BA.WB.U.3,Baltimore,18090782,0,2129,18088653,64097243,0.282239628,0.999882
no,LS.BA.WB.U.5,Baltimore,1007086,0,115,1006971,64097243,0.015711846,0.999886
no,LS.BA.WBO.U.3,Baltimore,4413030,0,529,4412501,74814215,0.058986517,0.99988
no,LS.BA.WBO.U.5,Baltimore,1364454,0,122,1364332,74814215,0.018237898,0.999911
no,LS.BO.HC2.M.5,Boston,1163094,0,104,1162990,112390624,0.010348675,0.999910583
no,LS.BO.HC4.M.2,Boston,7292868,0,805,7292063,112390624,0.06488858,0.999889618
no,LS.BO.HC4.M.3,Boston,4146758,0,483,4146275,76488205,0.054214346,0.999884
no,LS.BO.HC4.M.4,Boston,1170972,0,114,1170858,76488205,0.015309184,0.999903
no,LS.BO.I1.U.1,Boston,9712596,0,1018,9711578,50386273,0.192762739,0.999895
no,LS.BO.I2.U.1,Boston,5806686,0,660,5806026,50386273,0.115243412,0.999886
no,LS.BO.I2.U.3,Boston,11859502,0,1424,11858078,50386273,0.235371685,0.99988
no,LS.BO.I2.U.4,Boston,12372360,0,1363,12370997,65982292,0.18751031,0.99989
no,LS.BO.I2.U.5,Boston,9402378,0,1066,9401312,65982292,0.142498506,0.999887
no,LS.BO.I3.U.1,Boston,9242464,0,1093,9241371,65982292,0.140074916,0.999882
no,LS.BO.I4.U.1,Boston,28911908,0,3243,28908665,65982292,0.438176776,0.999888
no,LS.BO.I4.U.2,Boston,4589648,0,537,4589111,65982292,0.069558784,0.999883
no,LS.BO.LC1.M.2,Boston,1087240,0,134,1087106,76488205,0.014214479,0.999877
no,LS.BO.LC2.M.1,Boston,7958116,0,926,7957190,76488205,0.104043702,0.999884
no,LS.BO.LC4.M.2,Boston,16118610,0,1679,16116931,76488205,0.210733276,0.999896
no,LS.BO.LC4.M.3,Boston,18456108,0,2079,18454029,76488205,0.241293517,0.999887
no,LS.BO.LC4.M.4,Boston,8954382,0,1097,8953285,76488205,0.117068795,0.99987749
no,LS.BO.LC4.M.5,Boston,1597534,0,191,1597343,76488205,0.020886018,0.999880441
no,LS.BO.R1.U.1,Boston,13138992,0,1486,13137506,60010237,0.218945844,0.999887
no,LS.BO.R1.U.2,Boston,7326500,0,857,7325643,60010237,0.122087503,0.999883
no,LS.BO.R2.U.1,Boston,3304726,0,381,3304345,60010237,0.055069371,0.999885
no,LS.BO.R2.U.2,Boston,3588594,0,414,3588180,60010237,0.059799697,0.999885
no,LS.BO.R2.U.4,Boston,7753158,0,914,7752244,60010237,0.129197257,0.999882
no,LS.BO.R3.U.1,Boston,23989822,0,2668,23987154,60010237,0.399762161,0.999889
no,LS.BO.R3.U.2,Boston,41474098,0,4800,41469298,67481107,0.614603107,0.999884
no,LS.BO.R3.U.3,Boston,8818520,0,1023,8817497,67481107,0.130681318,0.999884
no,LS.BO.R4.U.1,Boston,1394896,0,164,1394732,67481107,0.020670912,0.999882
no,LS.BO.R4.U.2,Boston,3185250,0,357,3184893,67481107,0.047202101,0.999888
no,LS.BO.R4.U.4,Boston,3905558,0,429,3905129,67481107,0.057876318,0.99989
no,LS.BO.WL1.M.1,Boston,15821966,0,1891,15820075,76488205,0.206854978,0.999880483
no,LS.BO.WL1.M.2,Boston,7861860,0,917,7860943,45210173,0.173895818,0.999883
no,LS.BO.WL1.M.3,Boston,10143972,0,1183,10142789,45210173,0.22437366,0.999883
no,LS.BO.WL2.M.1,Boston,4418156,0,495,4417661,45210173,0.09772482,0.999888
no,LS.BO.WL2.M.2,Boston,5959250,0,657,5958593,45210173,0.131812148,0.99989
no,LS.BO.WL2.M.3,Boston,12683038,0,1370,12681668,45210173,0.280535047,0.999892
no,LS.BO.WL3.M.1,Boston,2620138,0,286,2619852,45210173,0.057954611,0.999891
no,LS.BO.WL3.M.3,Boston,9970934,0,1172,9969762,50386273,0.19788989,0.999882
no,LS.BO.WL3.M.4,Boston,8837306,0,1068,8836238,50386273,0.175391143,0.999879
no,LS.BO.WL3.M.5,Boston,3434524,0,387,3434137,50386273,0.068163883,0.999887
no,LS.LA.ARR.U.1,Los Angeles,10825122,0,1191,10823931,70167322,0.154275832,0.99989
no,LS.LA.ARR.U.2,Los Angeles,9652688,0,1112,9651576,70167322,0.137566715,0.999885
no,LS.LA.ARR.U.3,Los Angeles,6832194,0,776,6831418,70167322,0.097370026,0.99988642
no,LS.LA.ARR.U.4,Los Angeles,1870032,0,206,1869826,70167322,0.026651038,0.999889841
no,LS.LA.ARR.U.5,Los Angeles,10323918,0,1172,10322746,70167322,0.147132849,0.999886477
no,LS.LA.CAN.U.2,Los Angeles,11501326,0,1367,11499959,70673672,0.162738481,0.999881144
no,LS.LA.CAN.U.3,Los Angeles,8210726,0,901,8209825,70673672,0.116178002,0.999890265
no,LS.LA.CAN.U.5,Los Angeles,3214558,0,405,3214153,70673672,0.045484519,0.999874011
no,LS.LA.CRI.U.1,Los Angeles,10527704,0,1188,10526516,71228912,0.147800994,0.999887155
no,LS.LA.CRI.U.3,Los Angeles,8027776,0,987,8026789,71228912,0.112703898,0.999877052
no,LS.LA.CRI.U.4,Los Angeles,11457050,0,1279,11455771,71228912,0.160848308,0.999888366
no,LS.LA.CRI.U.5,Los Angeles,5324784,0,620,5324164,71228912,0.074755936,0.999883563
no,LS.LA.ESM.M.1,Los Angeles,1202764,0,127,1202637,48489652,0.02480455,0.999894
no,LS.LA.ESM.M.2,Los Angeles,3462614,0,419,3462195,48489652,0.071409339,0.999879
no,LS.LA.ESM.M.4,Los Angeles,1210758,0,124,1210634,48489652,0.02496941,0.999898
no,LS.LA.ESM.M.5,Los Angeles,21745886,0,2582,21743304,48489652,0.448464468,0.999881
no,LS.LA.FIG.U.1,Los Angeles,7663340,0,822,7662518,60646289,0.126361235,0.999893
no,LS.LA.FIG.U.3,Los Angeles,6713048,0,799,6712249,60646289,0.110691818,0.999881
no,LS.LA.FIG.U.5,Los Angeles,12774352,0,1433,12772919,60646289,0.210636994,0.999888
no,LS.LA.GLO.M.3,Los Angeles,13429700,0,1596,13428104,86717338,0.154867531,0.999881
no,LS.LA.GLO.M.5,Los Angeles,8392510,0,963,8391547,86717338,0.09678007,0.999885
no,LS.LA.GRI.M.1,Los Angeles,2780684,0,312,2780372,35725836,0.07783398,0.999888
no,LS.LA.GRI.M.3,Los Angeles,2541308,0,317,2540991,35725836,0.071133619,0.999875
no,LS.LA.HOW.U.1,Los Angeles,2200700,0,231,2200469,53440529,0.041180356,0.999895
no,LS.LA.HOW.U.3,Los Angeles,14119716,0,1684,14118032,60646289,0.232820775,0.999881
no,LS.LA.HOW.U.4,Los Angeles,11972776,0,1373,11971403,60646289,0.197419763,0.999885
no,LS.LA.HOW.U.5,Los Angeles,6642114,0,737,6641377,60646289,0.109522184,0.999889
no,LS.LA.MAD.M.1,Los Angeles,9579178,0,1048,9578130,46282440,0.206972191,0.999891
no,LS.LA.MAD.M.2,Los Angeles,14190446,0,1639,14188807,46282440,0.306605399,0.999884
no,LS.LA.MAD.M.4,Los Angeles,5059990,0,621,5059369,46282440,0.109328506,0.999877
no,LS.LA.MAR.U.1,Los Angeles,13091456,0,1555,13089901,71228912,0.183794131,0.99988122
no,LS.LA.MAR.U.3,Los Angeles,2965576,0,372,2965204,71228912,0.041634442,0.999874561
no,LS.LA.MRC.U.2,Los Angeles,7626544,0,930,7625614,70673672,0.107912095,0.999878057
no,LS.LA.MRC.U.3,Los Angeles,5066664,0,582,5066082,70673672,0.071690969,0.999885132
no,LS.LA.MRC.U.4,Los Angeles,1443868,0,159,1443709,70673672,0.020430069,0.999889879
no,LS.LA.MRC.U.5,Los Angeles,14774990,0,1705,14773285,70673672,0.209059323,0.999884602
no,LS.LA.NAV.M.2,Los Angeles,3654934,0,406,3654528,67212621,0.054378686,0.999889
no,LS.LA.NAV.M.4,Los Angeles,8693600,0,938,8692662,69160701,0.125701444,0.999892
no,LS.LA.NAV.M.5,Los Angeles,26007328,0,3158,26004170,69160701,0.376041995,0.999879
no,LS.LA.NVR.U.1,Los Angeles,8100142,0,898,8099244,53440529,0.151573013,0.999889
no,LS.LA.PAR.M.2,Los Angeles,2437478,0,304,2437174,48489652,0.050268004,0.999875
no,LS.LA.PAR.M.4,Los Angeles,15233426,0,1878,15231548,46282440,0.329140512,0.999877
no,LS.LA.SAN.U.1,Los Angeles,11378092,0,1244,11376848,59508219,0.191202025,0.999891
no,LS.LA.SAN.U.2,Los Angeles,8068220,0,928,8067292,59508219,0.135581608,0.999885
no,LS.LA.SAN.U.3,Los Angeles,3569574,0,439,3569135,59508219,0.059984554,0.999877
no,LS.LA.SAN.U.4,Los Angeles,3939282,0,413,3938869,59508219,0.066197276,0.999895
no,LS.LA.SAN.U.5,Los Angeles,10493736,0,1176,10492560,59508219,0.176340952,0.999888
no,LS.LA.SHO.M.1,Los Angeles,3508094,0,423,3507671,69160701,0.050723806,0.999879
no,LS.LA.SHO.M.2,Los Angeles,6963976,0,800,6963176,69160701,0.100692675,0.999885
no,LS.LA.SHO.M.3,Los Angeles,19257662,0,2273,19255389,69160701,0.278448045,0.999882
no,LS.LA.SHO.M.4,Los Angeles,1044830,0,139,1044691,69160701,0.015107279,0.999867
no,LS.LA.SHO.M.5,Los Angeles,3150486,0,347,3150139,69160701,0.045553124,0.99989
no,LS.LA.SSV.M.1,Los Angeles,14558112,0,1742,14556370,67212621,0.216597892,0.99988
no,LS.LA.SSV.M.2,Los Angeles,8821360,0,1055,8820305,67212621,0.131245589,0.99988
no,LS.LA.SSV.M.3,Los Angeles,9155026,0,1004,9154022,67212621,0.136209924,0.99989
no,LS.LA.SSV.M.4,Los Angeles,21365006,0,2603,21362403,67212621,0.317871937,0.999878
no,LS.LA.SSV.M.5,Los Angeles,8594194,0,984,8593210,67212621,0.127865777,0.999886
no,LS.LA.STO.U.1,Los Angeles,4749368,0,531,4748837,70167322,0.067686323,0.999888
no,LS.LA.STO.U.4,Los Angeles,9395722,0,1103,9394619,70167322,0.133904526,0.999883
no,LS.LA.VB1.U.1,Los Angeles,8030158,0,947,8029211,53440529,0.150263445,0.999882
no,LS.LA.VB1.U.2,Los Angeles,3270218,0,394,3269824,53440529,0.061193593,0.99988
no,LS.LA.VB1.U.3,Los Angeles,13407558,0,1510,13406048,53440529,0.250887449,0.999887
no,LS.LA.VB1.U.4,Los Angeles,17606016,0,2068,17603948,53440529,0.329450631,0.999883
no,LS.LA.VER.U.1,Los Angeles,1573520,0,200,1573320,71228912,0.02209103,0.999872896
no,LS.LA.VER.U.2,Los Angeles,14689594,0,1675,14687919,71228912,0.206230779,0.999885974
no,LS.LA.VER.U.5,Los Angeles,15720662,0,1845,15718817,70673672,0.222440147,0.999882639
no,LS.LA.VET.M.3,Los Angeles,8438988,0,935,8438053,35725836,0.23621527,0.999889
no,LS.LA.VET.M.4,Los Angeles,14432686,0,1642,14431044,35725836,0.403984556,0.999886
no,LS.LA.VET.M.5,Los Angeles,6285288,0,700,6284588,35725836,0.175931166,0.999889
no,LS.LA.VNH.M.2,Los Angeles,6030346,0,698,6029648,60880965,0.099051419,0.999884
no,LS.LA.VNH.M.4,Los Angeles,19524466,0,2161,19522305,60880965,0.320699023,0.999889
no,LS.LA.VNH.M.5,Los Angeles,17127354,0,2025,17125329,48489652,0.353216682,0.999882
no,LS.LA.WES.M.2,Los Angeles,11436386,0,1270,11435116,60880965,0.187848304,0.999889
no,LS.LA.WES.M.3,Los Angeles,7632374,0,873,7631501,60880965,0.125365523,0.999886
no,LS.LA.WES.M.4,Los Angeles,4366504,0,542,4365962,60880965,0.071721991,0.999876
no,LS.LA.WES.M.5,Los Angeles,10958114,0,1229,10956885,60880965,0.179992449,0.999888
no,LS.MN.L01-LS.M.1,Minneapolis,4966266,0,580,4965686,68833077,0.072149412,0.999883
no,LS.MN.L01-LS.M.2,Minneapolis,3625918,0,390,3625528,68833077,0.052676971,0.999892
no,LS.MN.L01-LS.M.4,Minneapolis,7186822,0,866,7185956,68833077,0.104409425,0.99988
no,LS.MN.L01-LS.U.1,Minneapolis,1286226,0,161,1286065,68833077,0.018686162,0.999875
no,LS.MN.L01-LS.U.2,Minneapolis,22074030,0,2385,22071645,51377193,0.429646478,0.999892
no,LS.MN.L01-LS.U.3,Minneapolis,16717246,0,1857,16715389,51377193,0.325382626,0.999889
no,LS.MN.L01-LS.U.4,Minneapolis,4513588,0,531,4513057,51377193,0.087851977,0.999882
no,LS.MN.L02-LS.U.1,Minneapolis,6732420,0,748,6731672,51377193,0.131039078,0.999889
no,LS.MN.L03-LS.U.2,Minneapolis,1688124,0,190,1687934,45650487,0.036979321,0.999887
no,LS.MN.L04-LS.U.2,Minneapolis,11056770,0,1353,11055417,45650487,0.242204864,0.999878
no,LS.MN.L05-LS.U.1,Minneapolis,4939062,0,509,4938553,45650487,0.108192975,0.999897
no,LS.MN.L05-LS.U.2,Minneapolis,5725092,0,621,5724471,45650487,0.125411411,0.999892
no,LS.MN.L05-LS.U.3,Minneapolis,4175094,0,460,4174634,45650487,0.091457819,0.999889823
no,LS.MN.L05-LS.U.4,Minneapolis,1601304,0,192,1601112,45650487,0.035077479,0.999880098
no,LS.MN.L05-LS.U.5,Minneapolis,14687988,0,1670,14686318,45650487,0.321748769,0.999886302
no,LS.MN.L06-LS.U.2,Minneapolis,7571880,0,854,7571026,69445011,0.109034182,0.999887
no,LS.MN.L06-LS.U.4,Minneapolis,6125482,0,712,6124770,69445011,0.088206221,0.999884
no,LS.MN.L06-LS.U.5,Minneapolis,7523360,0,824,7522536,69445011,0.1083355,0.99989
no,LS.MN.L07-LS.U.2,Minneapolis,6777814,0,793,6777021,69445011,0.097599725,0.999883
no,LS.MN.L07-LS.U.4,Minneapolis,18131224,0,1990,18129234,69445011,0.261087496,0.99989
no,LS.MN.L07-LS.U.5,Minneapolis,9464006,0,1086,9462920,69445011,0.136280575,0.999885249
no,LS.MN.L08-LS.U.1,Minneapolis,1714306,0,192,1714114,69445011,0.024685805,0.999888001
no,LS.MN.L08-LS.U.2,Minneapolis,10460452,0,1214,10459238,69445011,0.15062928,0.999883944
no,LS.MN.L08-LS.U.3,Minneapolis,8464130,0,1008,8463122,62548589,0.135320878,0.999881
no,LS.MN.L08-LS.U.5,Minneapolis,2150444,0,239,2150205,62548589,0.034380376,0.999889
no,LS.MN.L09-LS.U.3,Minneapolis,7859790,0,909,7858881,62548589,0.12565895,0.999884
no,LS.MN.L09-LS.U.5,Minneapolis,4250670,0,448,4250222,62548589,0.067957888,0.999895
no,LS.MN.L10-LS.U.1,Minneapolis,11607844,0,1371,11606473,62548589,0.185581229,0.999882
no,LS.MN.L10-LS.U.2,Minneapolis,6351552,0,758,6350794,62548589,0.101545888,0.999880659
no,LS.MN.L11-LS.U.1,Minneapolis,19576548,0,2312,19574236,62548589,0.312981449,0.9998819
no,LS.PX.ALA.M.2,Phoenix,10429368,0,1226,10428142,61258063,0.170252984,0.999882
no,LS.PX.ALA.M.3,Phoenix,15945346,0,1797,15943549,61258063,0.260297914,0.999887
no,LS.PX.ALA.M.4,Phoenix,3695410,0,420,3694990,61258063,0.060325283,0.999886
no,LS.PX.ALA.M.5,Phoenix,13084552,0,1374,13083178,61258063,0.213597221,0.999895
no,LS.PX.ALA.M.6,Phoenix,11421958,0,1331,11420627,61258063,0.186456402,0.999883
no,LS.PX.COY.M.3,Phoenix,3838820,0,458,3838362,62869089,0.061060532,0.999881
no,LS.PX.COY.M.4,Phoenix,7979324,0,954,7978370,57127677,0.139675275,0.99988
no,LS.PX.COY.M.5,Phoenix,2702828,0,335,2702493,57127677,0.047312059,0.999876
no,LS.PX.DOW.M.2,Phoenix,1989476,0,228,1989248,58191043,0.034188698,0.999885
no,LS.PX.DOW.M.3,Phoenix,1447862,0,178,1447684,65166517,0.022217882,0.999877
no,LS.PX.DOW.M.4,Phoenix,1662336,0,218,1662118,65166517,0.025509051,0.999869
no,LS.PX.ENC.M.2,Phoenix,2585306,0,288,2585018,62893881,0.041105843,0.999889
no,LS.PX.ENC.M.4,Phoenix,4874452,0,546,4873906,62893881,0.077502802,0.999888
no,LS.PX.ENC.M.5,Phoenix,1653266,0,179,1653087,58191043,0.028411005,0.999892
no,LS.PX.LAP.M.1,Phoenix,6556244,0,755,6555489,57423880,0.11417278,0.999885
no,LS.PX.LAP.M.2,Phoenix,1003764,0,137,1003627,57423880,0.017479906,0.999864
no,LS.PX.MAN.M.1,Phoenix,6020618,0,669,6019949,47210086,0.127528215,0.999889
no,LS.PX.MAN.M.2,Phoenix,7943882,0,948,7942934,47210086,0.168266628,0.999881
no,LS.PX.MAN.M.3,Phoenix,3687726,0,407,3687319,47210086,0.078113096,0.99989
no,LS.PX.MAN.M.4,Phoenix,5256298,0,615,5255683,47210086,0.111338454,0.999883
no,LS.PX.MAN.M.5,Phoenix,11832650,0,1360,11831290,47210086,0.250638179,0.999885
no,LS.PX.MON.U.2,Phoenix,7454490,0,907,7453583,69102464,0.107875893,0.999878
no,LS.PX.MON.U.3,Phoenix,7180214,0,770,7179444,69102464,0.103906772,0.999893
no,LS.PX.MON.U.5,Phoenix,3124006,0,359,3123647,69102464,0.045208316,0.999885
no,LS.PX.MON.U.7,Phoenix,2308148,0,282,2307866,61483712,0.037540804,0.999878
no,LS.PX.NUE.M.1,Phoenix,3744872,0,413,3744459,62321702,0.060089373,0.99989
no,LS.PX.NUE.M.3,Phoenix,2560498,0,265,2560233,62321702,0.041085174,0.999897
no,LS.PX.PAL.M.1,Phoenix,1773154,0,189,1772965,69863464,0.025380276,0.999893
no,LS.PX.PAL.M.2,Phoenix,4547912,0,530,4547382,69863464,0.065097144,0.999883
no,LS.PX.PAL.M.3,Phoenix,4961768,0,548,4961220,69863464,0.071020927,0.99989
no,LS.PX.PAL.M.5,Phoenix,1428516,0,139,1428377,69863464,0.020447254,0.999903
no,LS.PX.PIE.M.2,Phoenix,1464364,0,157,1464207,81546899,0.017957323,0.999893
no,LS.PX.PIE.M.4,Phoenix,2231564,0,256,2231308,81546899,0.027365406,0.999885
no,LS.PX.PIE.M.5,Phoenix,3138590,0,352,3138238,81546899,0.038488159,0.999888
no,LS.PX.PKW.U.1,Phoenix,1225782,0,134,1225648,64463929,0.019015006,0.999891
no,LS.PX.PKW.U.3,Phoenix,1083242,0,116,1083126,64463929,0.016803847,0.999893
no,LS.PX.PKW.U.5,Phoenix,2098084,0,226,2097858,64463929,0.032546635,0.999892
no,LS.PX.RPL.U.2,Phoenix,2522630,0,302,2522328,64970729,0.038827177,0.99988
no,LS.PX.RPL.U.3,Phoenix,2496902,0,294,2496608,64970729,0.038431183,0.999882
no,LS.PX.RPL.U.5,Phoenix,1421780,0,115,1421665,64970729,0.021883393,0.999919
no,PA.BA.AA.U.1,Baltimore,10504544,0,1233,10503311,74409858,0.141171402,0.999883
no,PA.BA.AA.U.2,Baltimore,15485754,0,1737,15484017,74409858,0.20811428,0.999888
no,PA.BA.AA.U.3,Baltimore,15553552,0,1730,15551822,74409858,0.209025422,0.999888771
no,PA.BA.AA.U.4,Baltimore,3657044,0,396,3656648,74409858,0.049147305,0.999891716
no,PA.BA.AA.U.5,Baltimore,6812996,0,849,6812147,74409858,0.091560395,0.999875385
no,PA.BA.LA.U.1,Baltimore,17949408,0,2082,17947326,69117528,0.25969401,0.999884007
no,PA.BA.LA.U.2,Baltimore,1795240,0,185,1795055,74098506,0.024227749,0.999897
no,PA.BA.LA.U.3,Baltimore,33626928,0,3944,33622984,74098506,0.453813846,0.999883
no,PA.BA.LA.U.5,Baltimore,33689640,0,3948,33685692,74098506,0.454660179,0.999883
no,PA.BA.LH-2.M.1,Baltimore,1124030,0,121,1123909,60920538,0.018450756,0.999892
no,PA.BA.LH-2.M.2,Baltimore,4172854,0,485,4172369,60920538,0.06849667,0.999884
no,PA.BA.LH-2.M.3,Baltimore,1845888,0,228,1845660,60920538,0.030299929,0.999876
no,PA.BA.LH-2.M.4,Baltimore,1804450,0,228,1804222,60920538,0.029619732,0.999874
no,PA.BA.LH-2.M.5,Baltimore,22207800,0,2514,22205286,60920538,0.364537162,0.999887
no,PA.BA.LH-3.M.1,Baltimore,12686556,0,1417,12685139,62855778,0.201835955,0.999888
no,PA.BA.LH-3.M.2,Baltimore,3134682,0,339,3134343,62855778,0.049871024,0.999892
no,PA.BA.LH-3.M.3,Baltimore,6649932,0,833,6649099,62855778,0.10579667,0.999875
no,PA.BA.LH-3.M.4,Baltimore,1505366,0,167,1505199,62855778,0.023949525,0.999889
no,PA.BA.LH-3.M.5,Baltimore,9837394,0,1105,9836289,62855778,0.156507394,0.999888
no,PA.BA.LL-3.M.1,Baltimore,3844636,0,442,3844194,60577660,0.063466235,0.999885035
no,PA.BA.LL-3.M.2,Baltimore,26229972,0,3057,26226915,60577660,0.432997445,0.999883454
no,PA.BA.LL-3.M.3,Baltimore,41754510,0,4858,41749652,77599742,0.538075371,0.999884
no,PA.BA.LL-3.M.4,Baltimore,1661896,0,201,1661695,77599742,0.021416257,0.999879
no,PA.BA.LL-3.M.5,Baltimore,9247534,0,1064,9246470,77599742,0.119169649,0.999885
no,PA.BA.LL-4.M.1,Baltimore,1149988,0,126,1149862,48337955,0.02379058,0.99989
no,PA.BA.LL-4.M.2,Baltimore,26431240,0,3041,26428199,48337955,0.546800956,0.999885
no,PA.BA.LL-4.M.3,Baltimore,4291842,0,460,4291382,62253435,0.068941449,0.999893
no,PA.BA.LL-4.M.4,Baltimore,33163518,0,3688,33159830,62253435,0.532717881,0.999889
no,PA.BA.PIK.U.1,Baltimore,3955970,0,439,3955531,51217894,0.077238045,0.999889
no,PA.BA.PIK.U.3,Baltimore,12452456,0,1401,12451055,51217894,0.24312706,0.999887
no,PA.BA.PIK.U.4,Baltimore,2810628,0,310,2810318,70999844,0.039586397,0.99989
no,PA.BA.PIK.U.5,Baltimore,17357140,0,2102,17355038,70999844,0.244467298,0.999879
no,PA.BA.PSP.M.1,Baltimore,4462654,0,490,4462164,58844908,0.075837556,0.9998902
no,PA.BA.PSP.M.2,Baltimore,15644590,0,1877,15642713,58844908,0.265861406,0.999880022
no,PA.BA.RG-1.M.1,Baltimore,1101378,0,131,1101247,60577660,0.018181257,0.999881
no,PA.BA.RG-1.M.2,Baltimore,9278556,0,1143,9277413,60577660,0.15316795,0.999877
no,PA.BA.RG-1.M.3,Baltimore,4881744,0,547,4881197,60577660,0.08058654,0.999888
no,PA.BA.RG-1.M.4,Baltimore,5269208,0,583,5268625,60577660,0.086982693,0.999889
no,PA.BA.RG-1.M.5,Baltimore,5080422,0,525,5079897,60577660,0.083866264,0.999896662
no,PA.BA.RG-2.M.2,Baltimore,19135198,0,2244,19132954,51635318,0.370583522,0.999883
no,PA.BA.RG-2.M.4,Baltimore,6430476,0,711,6429765,60069844,0.107049987,0.999889
no,PA.BA.W3.M.2,Baltimore,24994498,0,2889,24991609,60920538,0.410280323,0.999884
no,PA.BA.W3.M.3,Baltimore,2455258,0,280,2454978,50880761,0.048255135,0.999886
no,PA.BA.W3.M.4,Baltimore,28641814,0,3406,28638408,50880761,0.562920315,0.999881
no,PA.BA.WB.U.1,Baltimore,7212354,0,828,7211526,49605300,0.145394827,0.999885
no,PA.BA.WB.U.2,Baltimore,10202334,0,1060,10201274,49605300,0.205670241,0.999896
no,PA.BA.WB.U.3,Baltimore,1605604,0,185,1605419,49605300,0.03236759,0.999885
no,PA.BA.WB.U.4,Baltimore,5996394,0,743,5995651,49605300,0.120882123,0.999876
no,PA.BA.WGP.M.1,Baltimore,20151826,0,2429,20149397,41689606,0.483377703,0.999879
no,PA.BA.WGP.M.2,Baltimore,5056842,0,574,5056268,41689606,0.121297428,0.999886
no,PA.BA.WGP.M.3,Baltimore,7417176,0,860,7416316,41689606,0.177914274,0.999884
no,PA.BA.WGP.M.4,Baltimore,1279586,0,156,1279430,41689606,0.030693166,0.999878
no,PA.BA.WGP.M.5,Baltimore,19668828,0,2209,19666619,48337955,0.406902361,0.999888
no,PA.BO.HC1.M.1,Boston,15232204,0,1790,15230414,55195790,0.275966772,0.999882
no,PA.BO.HC1.M.2,Boston,18526414,0,2125,18524289,55195790,0.335649041,0.999885
no,PA.BO.HC1.M.3,Boston,1219724,0,150,1219574,55195790,0.022098135,0.999877
no,PA.BO.HC1.M.4,Boston,2631420,0,287,2631133,55195790,0.047674288,0.999891
no,PA.BO.HC1.M.5,Boston,1601686,0,201,1601485,55195790,0.029018264,0.999875
no,PA.BO.HC2.M.1,Boston,12874670,0,1545,12873125,77735598,0.16562129,0.99988
no,PA.BO.HC2.M.2,Boston,3395058,0,377,3394681,77735598,0.043674431,0.999888956
no,PA.BO.HC2.M.4,Boston,11981946,0,1423,11980523,77735598,0.154137182,0.999881238
no,PA.BO.HC2.M.5,Boston,10143564,0,1218,10142346,72901024,0.139141585,0.99988
no,PA.BO.HC4.M.1,Boston,4424470,0,509,4423961,70663733,0.062613024,0.999885
no,PA.BO.HC4.M.3,Boston,29268674,0,3397,29265277,70663733,0.414196544,0.999884
no,PA.BO.HC4.M.4,Boston,25412640,0,2861,25409779,65309760,0.389109377,0.999887
no,PA.BO.HC4.M.5,Boston,17656772,0,1987,17654785,65309760,0.270354263,0.999887
no,PA.BO.I1.U.1,Boston,14574976,0,1745,14573231,54093537,0.269440248,0.99988
no,PA.BO.I1.U.2,Boston,3184416,0,330,3184086,54093537,0.058868696,0.999896
no,PA.BO.I1.U.3,Boston,12176590,0,1397,12175193,54093537,0.225102492,0.999885
no,PA.BO.I1.U.4,Boston,1181394,0,106,1181288,54093537,0.021839836,0.99991
no,PA.BO.I1.U.5,Boston,8040618,0,895,8039723,54093537,0.148642859,0.999889
no,PA.BO.I2.U.2,Boston,10277848,0,1238,10276610,54093537,0.190001404,0.99988
no,PA.BO.I2.U.3,Boston,8490046,0,1056,8488990,55195790,0.153816912,0.999876
no,PA.BO.I2.U.4,Boston,3160944,0,341,3160603,55195790,0.057267846,0.999892
no,PA.BO.I2.U.5,Boston,4339808,0,506,4339302,55195790,0.078625707,0.999883
no,PA.BO.I4.U.2,Boston,15650418,0,1778,15648640,83714210,0.186950555,0.999886393
no,PA.BO.I4.U.4,Boston,8898566,0,939,8897627,77735598,0.114472214,0.999894
no,PA.BO.LC1.M.2,Boston,2926370,0,313,2926057,83714210,0.03495667,0.999893
no,PA.BO.LC2.M.1,Boston,15827718,0,1785,15825933,89041912,0.177755819,0.999887
no,PA.BO.LC2.M.2,Boston,5747628,0,637,5746991,89041912,0.064549692,0.999889172
no,PA.BO.LC2.M.3,Boston,1250418,0,136,1250282,89041912,0.014043027,0.999891236
no,PA.BO.LC2.M.4,Boston,6504784,0,744,6504040,89041912,0.073053058,0.999885623
no,PA.BO.LC2.M.5,Boston,4549444,0,519,4548925,54093537,0.084103282,0.999886
no,PA.BO.LC3.M.2,Boston,10149812,0,1099,10148713,72901024,0.13922729,0.999892
no,PA.BO.LC3.M.3,Boston,13277052,0,1561,13275491,72901024,0.182124355,0.999882
no,PA.BO.LC3.M.4,Boston,10700670,0,1204,10699466,72901024,0.146783535,0.999887484
no,PA.BO.LC4.M.1,Boston,13717780,0,1571,13716209,77735598,0.176467157,0.999885
no,PA.BO.LC4.M.2,Boston,19362816,0,2251,19360565,77735598,0.249085573,0.999884
no,PA.BO.LC4.M.4,Boston,5175134,0,617,5174517,77735598,0.066573541,0.999881
no,PA.BO.R1.U.1,Boston,1015482,0,111,1015371,72901024,0.013929599,0.999891
no,PA.BO.R1.U.2,Boston,2810502,0,337,2810165,72901024,0.038552298,0.99988
no,PA.BO.R1.U.4,Boston,1807026,0,233,1806793,72901024,0.024787388,0.999871
no,PA.BO.R1.U.5,Boston,13591406,0,1580,13589826,72901024,0.186436421,0.999884
no,PA.BO.R3.U.1,Boston,16579848,0,1953,16577895,70663733,0.234630231,0.999882
no,PA.BO.R3.U.2,Boston,9967400,0,1116,9966284,70663733,0.141053969,0.999888
no,PA.BO.R3.U.3,Boston,1857544,0,230,1857314,70663733,0.026287091,0.999876
no,PA.BO.R3.U.4,Boston,7746304,0,946,7745358,70663733,0.10962206,0.999878
no,PA.BO.R4.U.2,Boston,19029648,0,2225,19027423,66864334,0.284600876,0.999883
no,PA.BO.R4.U.3,Boston,1620882,0,211,1620671,66864334,0.024241354,0.99987
no,PA.BO.R4.U.4,Boston,5546736,0,625,5546111,66864334,0.082955077,0.999887
no,PA.BO.WL1.M.1,Boston,19746540,0,2226,19744314,89041912,0.221766801,0.999887
no,PA.BO.WL1.M.2,Boston,7800652,0,914,7799738,89041912,0.08760652,0.999883
no,PA.BO.WL1.M.3,Boston,1962776,0,216,1962560,89041912,0.022043282,0.99989
no,PA.BO.WL1.M.4,Boston,18324146,0,2034,18322112,89041912,0.205792369,0.999889
no,PA.BO.WL2.M.1,Boston,2622542,0,278,2622264,66864334,0.039221837,0.999894
no,PA.BO.WL2.M.2,Boston,21185474,0,2602,21182872,66864334,0.316842668,0.999877
no,PA.BO.WL2.M.4,Boston,15852408,0,1761,15850647,66864334,0.237083166,0.999889
no,PA.BO.WL2.M.5,Boston,11673514,0,1372,11672142,83714210,0.139444833,0.999882
no,PA.BO.WL3.M.1,Boston,1303250,0,141,1303109,72901024,0.017876978,0.999891809
no,PA.BO.WL3.M.2,Boston,7248222,0,870,7247352,72901024,0.099425517,0.999879971
no,PA.BO.WL3.M.4,Boston,10637056,0,1357,10635699,89041912,0.119461226,0.999872
no,PA.BO.WL4.M.1,Boston,14671984,0,1638,14670346,83714210,0.175262766,0.999888
no,PA.BO.WL4.M.3,Boston,19928980,0,2325,19926655,83714210,0.238059703,0.999883
no,PA.BO.WL4.M.4,Boston,12346202,0,1331,12344871,83714210,0.147480362,0.999892
no,PA.BO.WL4.M.5,Boston,3203362,0,360,3203002,83714210,0.038265451,0.999887618
no,PA.LA.ALL.M.4,Los Angeles,21524734,0,2621,21522113,54124327,0.397690562,0.999878
no,PA.LA.ALL.M.5,Los Angeles,21599356,0,2429,21596927,54124327,0.399069276,0.999888
no,PA.LA.GLO.M.2,Los Angeles,1614996,0,201,1614795,93470629,0.017278112,0.999876
no,PA.LA.GLO.M.3,Los Angeles,30132842,0,3480,30129362,93470629,0.322377653,0.999885
no,PA.LA.GLO.M.4,Los Angeles,3815524,0,418,3815106,93470629,0.040820566,0.999890448
no,PA.LA.GLO.M.5,Los Angeles,5367670,0,624,5367046,93470629,0.057426275,0.999883748
no,PA.LA.KIN.M.2,Los Angeles,3662510,0,467,3662043,54258268,0.067501417,0.999872
no,PA.LA.KIN.M.4,Los Angeles,6047484,0,635,6046849,54258268,0.111457373,0.999895
no,PA.LA.KIN.M.5,Los Angeles,22723484,0,2533,22720951,61417779,0.369982184,0.999889
no,PA.LA.LUB.M.1,Los Angeles,1075234,0,148,1075086,53604939,0.020058488,0.999862
no,PA.LA.LUB.M.2,Los Angeles,7266730,0,879,7265851,53604939,0.13556083,0.999879
no,PA.LA.LUB.M.4,Los Angeles,14002310,0,1627,14000683,53604939,0.261213057,0.999884
no,PA.LA.LUB.M.5,Los Angeles,29888396,0,3271,29885125,53604939,0.557567951,0.999891
no,PA.LA.NWH.M.1,Los Angeles,13821382,0,1554,13819828,86827234,0.159182567,0.999888
no,PA.LA.NWH.M.2,Los Angeles,6633586,0,775,6632811,86827234,0.076399831,0.999883
no,PA.LA.NWH.M.3,Los Angeles,10406752,0,1201,10405551,86827234,0.119855851,0.999885
no,PA.LA.NWH.M.4,Los Angeles,15172006,0,1751,15170255,86827234,0.174737871,0.99988459
no,PA.LA.NWH.M.5,Los Angeles,4882250,0,585,4881665,86827234,0.056229477,0.999880178
no,PA.LA.POP.M.1,Los Angeles,24050010,0,2851,24047159,54447850,0.441707248,0.999881
no,PA.LA.POP.M.3,Los Angeles,20434902,0,2430,20432472,54447850,0.375311459,0.999881
no,PA.LA.POP.M.4,Los Angeles,1303786,0,143,1303643,55010486,0.023700681,0.99989
no,PA.LA.POP.M.5,Los Angeles,46405394,0,5380,46400014,55010486,0.843573605,0.999884
no,PA.LA.ROS.M.1,Los Angeles,20899798,0,2432,20897366,59636458,0.350453375,0.999884
no,PA.LA.ROS.M.3,Los Angeles,33380184,0,3708,33376476,59636458,0.559727809,0.999889
no,PA.LA.ROS.M.4,Los Angeles,1682432,0,205,1682227,63000304,0.026705141,0.999878
no,PA.LA.ROS.M.5,Los Angeles,19326392,0,2326,19324066,63000304,0.306766647,0.99988
no,PA.LA.SEP.M.1,Los Angeles,15570070,0,1831,15568239,60069844,0.259199441,0.999882
no,PA.LA.SEP.M.2,Los Angeles,26237564,0,2991,26234573,60069844,0.436784287,0.999886
no,PA.LA.SEP.M.4,Los Angeles,7729748,0,942,7728806,60069844,0.128679342,0.999878
no,PA.LA.SEP.M.5,Los Angeles,2430136,0,263,2429873,60069844,0.040455174,0.999892
no,PA.LA.WHI.M.2,Los Angeles,14736884,0,1688,14735196,63000304,0.233917665,0.999885
no,PA.LA.WHI.M.3,Los Angeles,18483718,0,2129,18481589,63000304,0.293390933,0.999885
no,PA.LA.WHI.M.4,Los Angeles,1421640,0,168,1421472,63000304,0.022565605,0.999882
no,PA.LA.WHI.M.5,Los Angeles,6293878,0,763,6293115,63000304,0.099902343,0.999879
no,PA.LA.ZOO.M.1,Los Angeles,1053426,0,102,1053324,85384472,0.012337442,0.999903
no,PA.LA.ZOO.M.3,Los Angeles,10067408,0,1190,10066218,85384472,0.117906778,0.999882
no,PA.LA.ZOO.M.4,Los Angeles,1368316,0,156,1368160,85384472,0.016025349,0.999886
no,PA.LA.ZOO.M.5,Los Angeles,5598550,0,599,5597951,85384472,0.065568714,0.999893
no,PA.MN.L01-TO_PA.M.4,Minneapolis,22951796,0,2604,22949192,68833077,0.333441377,0.999887
no,PA.MN.L01-TO_PA.M.5,Minneapolis,28294288,0,3306,28290982,68833077,0.411056562,0.999883
no,PA.PX.ALA.M.1,Phoenix,2530290,0,318,2529972,55300858,0.045754986,0.999874
no,PA.PX.ALA.M.2,Phoenix,20205750,0,2337,20203413,55300858,0.365378599,0.999884
no,PA.PX.ALA.M.3,Phoenix,25192828,0,2817,25190011,55300858,0.455559442,0.999888
no,PA.PX.ALA.M.5,Phoenix,1578156,0,191,1577965,55300858,0.02853764,0.999879
no,PA.PX.BUF.M.1,Phoenix,3004546,0,313,3004233,128621666,0.023359564,0.999896
no,PA.PX.BUF.M.2,Phoenix,17483480,0,2125,17481355,128621666,0.13592951,0.999878
no,PA.PX.BUF.M.3,Phoenix,15550102,0,1789,15548313,128621666,0.120897999,0.999885
no,PA.PX.BUF.M.4,Phoenix,22127394,0,2518,22124876,128621666,0.172034733,0.999886204
no,PA.PX.COY.M.1,Phoenix,31839176,0,3560,31835616,51854414,0.614010911,0.999888
no,PA.PX.DF1.M.2,Phoenix,2506914,0,309,2506605,64562580,0.03882921,0.999877
no,PA.PX.DF1.M.5,Phoenix,26389636,0,2937,26386699,64562580,0.408745066,0.999889
no,PA.PX.ENC.M.2,Phoenix,11785790,0,1314,11784476,62893881,0.18739168,0.999889
no,PA.PX.ENC.M.3,Phoenix,21985736,0,2558,21983178,62893881,0.34956876,0.999884
no,PA.PX.ENC.M.4,Phoenix,6887708,0,784,6886924,62893881,0.109513166,0.999886
no,PA.PX.ENC.M.5,Phoenix,14506168,0,1577,14504591,62893881,0.23064514,0.999891
no,PA.PX.LAP.M.1,Phoenix,1383234,0,171,1383063,62954635,0.021971917,0.999876
no,PA.PX.LAP.M.2,Phoenix,28825832,0,3220,28822612,62954635,0.457882601,0.999888
no,PA.PX.LAP.M.4,Phoenix,10340898,0,1236,10339662,62954635,0.164259518,0.99988
no,PA.PX.LAP.M.5,Phoenix,1209414,0,140,1209274,62602478,0.019318948,0.999884
no,PA.PX.PAP.M.1,Phoenix,1445858,0,167,1445691,69863464,0.020695481,0.999884
no,PA.PX.PAP.M.2,Phoenix,7742716,0,934,7741782,71065601,0.108951671,0.999879
no,PA.PX.PAP.M.3,Phoenix,26713224,0,3093,26710131,71065601,0.37589528,0.999884
no,PA.PX.PAP.M.4,Phoenix,5556516,0,622,5555894,71065601,0.078188546,0.999888
no,PA.PX.PAP.M.5,Phoenix,7290224,0,860,7289364,71065601,0.102584428,0.999882
no,PA.PX.PIE.M.1,Phoenix,22017648,0,2486,22015162,81546899,0.269999819,0.999887091
no,PA.PX.PIE.M.2,Phoenix,1484694,0,189,1484505,81546899,0.018206627,0.999872701
no,PA.PX.PIE.M.3,Phoenix,23702286,0,2779,23699507,81546899,0.290658336,0.999882754
no,PA.PX.PIE.M.4,Phoenix,19894514,0,2188,19892326,62954635,0.316013491,0.99989
no,PA.PX.RPP.U.1,Phoenix,2689190,0,290,2688900,64970729,0.041390793,0.999892
no,PA.PX.RPP.U.2,Phoenix,1303640,0,143,1303497,32562816,0.040034621,0.99989
no,PA.PX.RPP.U.3,Phoenix,14072004,0,1619,14070385,32562816,0.43214948,0.999885
no,PA.PX.RPP.U.5,Phoenix,17093748,0,1897,17091851,32562816,0.52494686,0.999889
no,TE.LA.ALL.M.1,Los Angeles,1151330,0,117,1151213,54124327,0.02127195,0.999898
no,TE.LA.ALL.M.2,Los Angeles,5203348,0,558,5202790,54124327,0.096136955,0.999893
no,TE.LA.ALL.M.3,Los Angeles,1216484,0,145,1216339,54124327,0.022475734,0.999881
no,TO.BA.AA.U.2,Baltimore,9681050,0,1100,9679950,79298889,0.122083047,0.999886376
no,TO.BA.AA.U.3,Baltimore,12113818,0,1348,12112470,84324103,0.143657834,0.999889
no,TO.BA.AA.U.5,Baltimore,3266980,0,393,3266587,84324103,0.038743134,0.99988
no,TO.BA.CP.U.1,Baltimore,1645560,0,193,1645367,48518859,0.033915884,0.999883
no,TO.BA.CP.U.2,Baltimore,1948598,0,225,1948373,48518859,0.040161662,0.999885
no,TO.BA.CP.U.3,Baltimore,4446924,0,547,4446377,48518859,0.091653516,0.999877
no,TO.BA.CP.U.4,Baltimore,10007640,0,1084,10006556,48518859,0.206262888,0.999892
no,TO.BA.DHI.U.1,Baltimore,23052370,0,2648,23049722,52632412,0.437988098,0.999885131
no,TO.BA.DHI.U.2,Baltimore,1989942,0,226,1989716,52632412,0.0378083,0.999886429
no,TO.BA.DHI.U.3,Baltimore,3451444,0,394,3451050,52632412,0.065576398,0.999885845
no,TO.BA.DHI.U.4,Baltimore,1719288,0,187,1719101,52632412,0.032665955,0.999891234
no,TO.BA.DHI.U.5,Baltimore,17569260,0,2057,17567203,49254844,0.35670116,0.999883
no,TO.BA.FH.U.1,Baltimore,12829156,0,1463,12827693,69878891,0.183591294,0.999886
no,TO.BA.FH.U.2,Baltimore,17350990,0,2003,17348987,69878891,0.248300878,0.999885
no,TO.BA.FH.U.4,Baltimore,2713462,0,301,2713161,69878891,0.038830925,0.999889
no,TO.BA.FH.U.5,Baltimore,1113256,0,153,1113103,69878891,0.01593122,0.999863
no,TO.BA.GA.U.1,Baltimore,19648426,0,2134,19646292,55802660,0.352105545,0.999891
no,TO.BA.GA.U.2,Baltimore,10562064,0,1218,10560846,55802660,0.189275278,0.999885
no,TO.BA.GA.U.3,Baltimore,5552376,0,603,5551773,55802660,0.099500203,0.999891
no,TO.BA.GA.U.4,Baltimore,6163866,0,729,6163137,55802660,0.110458283,0.999882
no,TO.BA.GA.U.5,Baltimore,1287482,0,178,1287304,55802660,0.023072054,0.999862
no,TO.BA.LH-1.M.2,Baltimore,2187934,0,212,2187722,74814215,0.029244897,0.999903105
no,TO.BA.LH-1.M.4,Baltimore,2698794,0,301,2698493,74814215,0.036073278,0.999888469
no,TO.BA.LH-1.M.5,Baltimore,12902008,0,1474,12900534,51635318,0.249867891,0.999886
no,TO.BA.LH-2.M.1,Baltimore,7542002,0,890,7541112,72248024,0.104390426,0.999882
no,TO.BA.LH-2.M.2,Baltimore,6192152,0,729,6191423,72248024,0.08570687,0.99988227
no,TO.BA.LH-2.M.3,Baltimore,1095430,0,122,1095308,72248024,0.015162076,0.999888628
no,TO.BA.LH-2.M.4,Baltimore,6633218,0,807,6632411,72248024,0.091811757,0.99987834
no,TO.BA.LH-3.M.2,Baltimore,4002416,0,451,4001965,79298889,0.050472536,0.999887
no,TO.BA.LH-3.M.4,Baltimore,8936328,0,1066,8935262,79298889,0.112691718,0.999881
no,TO.BA.LH-3.M.5,Baltimore,16126730,0,1776,16124954,79298889,0.203366405,0.99989
no,TO.BA.LL-3.M.1,Baltimore,4686696,0,483,4686213,77599742,0.060395768,0.999897
no,TO.BA.LL-3.M.2,Baltimore,1139166,0,127,1139039,77599742,0.014680023,0.999888515
no,TO.BA.LL-3.M.4,Baltimore,12402744,0,1443,12401301,77599742,0.159829707,0.999883655
no,TO.BA.ML.U.1,Baltimore,4155586,0,441,4155145,90171417,0.046085402,0.999893878
no,TO.BA.ML.U.2,Baltimore,22125404,0,2672,22122732,90171417,0.245370481,0.999879234
no,TO.BA.ML.U.3,Baltimore,1995048,0,220,1994828,72248024,0.027613876,0.99989
no,TO.BA.ML.U.5,Baltimore,2716468,0,303,2716165,72248024,0.037599201,0.999888
no,TO.BA.PIK.U.2,Baltimore,13186770,0,1572,13185198,49254844,0.267725343,0.999881
no,TO.BA.PIK.U.3,Baltimore,2310784,0,278,2310506,56048839,0.041228044,0.99988
no,TO.BA.PIK.U.4,Baltimore,5508376,0,627,5507749,56048839,0.098278146,0.999886
no,TO.BA.PIK.U.5,Baltimore,1545394,0,182,1545212,56048839,0.027572275,0.999882
no,TO.BA.PSP.M.1,Baltimore,2022570,0,238,2022332,50880761,0.039751174,0.999882
no,TO.BA.PSP.M.2,Baltimore,15579164,0,1790,15577374,50880761,0.306189681,0.999885
no,TO.BA.PSP.M.4,Baltimore,1649030,0,172,1648858,50880761,0.032409696,0.999896
no,TO.BA.RG-1.M.2,Baltimore,1188222,0,140,1188082,60577660,0.019614855,0.999882
no,TO.BA.RG-1.M.4,Baltimore,1388730,0,162,1388568,60577660,0.022924788,0.999883
no,TO.BA.RG-1.M.5,Baltimore,2214350,0,256,2214094,60577660,0.036553905,0.999884
no,TO.BA.RG-2.M.1,Baltimore,1054986,0,108,1054878,51635318,0.020431481,0.999898
no,TO.BA.RG-2.M.2,Baltimore,3413778,0,375,3413403,51635318,0.066113237,0.99989
no,TO.BA.RG-2.M.4,Baltimore,1126558,0,126,1126432,51635318,0.021817586,0.999888
no,TO.BA.RG-2.M.5,Baltimore,12980482,0,1505,12978977,51635318,0.251387665,0.999884
no,TO.BA.TRC.U.1,Baltimore,2980622,0,332,2980290,84324103,0.035347213,0.999888614
no,TO.BA.TRC.U.2,Baltimore,2230718,0,265,2230453,84324103,0.026454097,0.999881204
no,TO.BA.TRC.U.3,Baltimore,8839408,0,967,8838441,84324103,0.104826588,0.999890604
no,TO.BA.W3.M.2,Baltimore,11279620,0,1236,11278384,72067799,0.156514007,0.99989
no,TO.BA.W3.M.3,Baltimore,14813574,0,1661,14811913,65406361,0.226485219,0.999888
no,TO.BA.W3.M.4,Baltimore,12133466,0,1405,12132061,65406361,0.18550896,0.999884
no,TO.BA.W3.M.5,Baltimore,3468474,0,434,3468040,65406361,0.053029613,0.999875
no,TO.BA.WB.U.1,Baltimore,8644990,0,1024,8643966,54931058,0.157378909,0.999882
no,TO.BA.WB.U.2,Baltimore,8911752,0,1093,8910659,54931058,0.162235215,0.999877
no,TO.BA.WB.U.4,Baltimore,4753452,0,542,4752910,54931058,0.086534871,0.999886
no,TO.BA.WBO.U.2,Baltimore,5220124,0,603,5219521,53535102,0.097508435,0.999884
no,TO.BA.WBO.U.4,Baltimore,1753984,0,216,1753768,53535102,0.032763251,0.999877
no,TO.BA.WGP.M.1,Baltimore,1680556,0,178,1680378,64392576,0.026098599,0.999894
no,TO.BA.WGP.M.3,Baltimore,6462012,0,807,6461205,41689606,0.155002952,0.999875
no,TO.BA.WGP.M.5,Baltimore,1041272,0,138,1041134,41689606,0.024976777,0.999867
no,TO.BO.HC1.M.1,Boston,13554358,0,1633,13552725,58789797,0.230556299,0.99988
no,TO.BO.HC1.M.2,Boston,10011022,0,1186,10009836,58789797,0.170285024,0.999882
no,TO.BO.HC1.M.3,Boston,2712328,0,307,2712021,58789797,0.046136033,0.999887
no,TO.BO.HC1.M.4,Boston,6205690,0,687,6205003,58789797,0.105557262,0.999889
no,TO.BO.HC2.M.1,Boston,22576816,0,2436,22574380,58789797,0.384026092,0.999892
no,TO.BO.HC2.M.3,Boston,2203548,0,271,2203277,58789797,0.03748181,0.999877
no,TO.BO.HC2.M.4,Boston,1076356,0,132,1076224,58789797,0.018308551,0.999877
no,TO.BO.HC2.M.5,Boston,7273102,0,846,7272256,49249084,0.147679945,0.999884
no,TO.BO.HC3.M.1,Boston,8646514,0,980,8645534,49249084,0.175567001,0.999887
no,TO.BO.HC3.M.2,Boston,2365692,0,264,2365428,49249084,0.048035249,0.999888
no,TO.BO.HC3.M.3,Boston,3772042,0,447,3771595,49249084,0.07659111,0.999881
no,TO.BO.HC3.M.4,Boston,25546716,0,2991,25543725,49249084,0.518724693,0.999883
no,TO.BO.HC4.M.4,Boston,13258682,0,1522,13257160,56315549,0.235435546,0.999885
no,TO.BO.HC4.M.5,Boston,7301248,0,808,7300440,56315549,0.129648883,0.999889
no,TO.BO.I1.U.1,Boston,7319952,0,874,7319078,52866544,0.138460952,0.999881
no,TO.BO.I1.U.2,Boston,5154840,0,606,5154234,52866544,0.097506658,0.999882
no,TO.BO.I1.U.3,Boston,7431282,0,842,7430440,52866544,0.14056682,0.999887
no,TO.BO.I1.U.5,Boston,4572694,0,501,4572193,52866544,0.086495043,0.99989
no,TO.BO.I2.U.2,Boston,14436338,0,1653,14434685,52866544,0.27307134,0.999885
no,TO.BO.I2.U.3,Boston,7728104,0,930,7727174,44452651,0.173850239,0.99988
no,TO.BO.I2.U.4,Boston,15101574,0,1709,15099865,44452651,0.339722686,0.999887
no,TO.BO.I2.U.5,Boston,3777716,0,417,3777299,44452651,0.084982918,0.99989
no,TO.BO.I3.U.1,Boston,7215520,0,802,7214718,44452651,0.162319228,0.999889
no,TO.BO.I3.U.2,Boston,8013124,0,829,8012295,44452651,0.180262005,0.999897
no,TO.BO.I3.U.4,Boston,1441798,0,176,1441622,44452651,0.032434466,0.999878
no,TO.BO.I4.U.2,Boston,12840034,0,1402,12838632,70134999,0.183075985,0.999891
no,TO.BO.I4.U.4,Boston,2622142,0,303,2621839,70134999,0.037387068,0.999884
no,TO.BO.LC1.M.1,Boston,2099168,0,265,2098903,56315549,0.037275105,0.999874
no,TO.BO.LC1.M.2,Boston,10008168,0,1169,10006999,56315549,0.177715892,0.999883
no,TO.BO.LC1.M.4,Boston,9382382,0,1147,9381235,56315549,0.166603756,0.999878
no,TO.BO.LC2.M.1,Boston,13364016,0,1433,13362583,56315549,0.23730597,0.999893
no,TO.BO.LC2.M.2,Boston,11688456,0,1305,11687151,54020903,0.216369134,0.999888
no,TO.BO.LC2.M.3,Boston,13303726,0,1619,13302107,54020903,0.246269967,0.999878
no,TO.BO.LC2.M.5,Boston,16328838,0,1856,16326982,54020903,0.302268883,0.999886
no,TO.BO.LC3.M.1,Boston,10412330,0,1215,10411115,54020903,0.192746315,0.999883
no,TO.BO.LC3.M.5,Boston,5043760,0,579,5043181,50326092,0.100221571,0.999885
no,TO.BO.LC4.M.1,Boston,14966698,0,1689,14965009,50326092,0.297394401,0.999887
no,TO.BO.LC4.M.2,Boston,1876448,0,254,1876194,50326092,0.037285788,0.999865
no,TO.BO.LC4.M.3,Boston,6513862,0,748,6513114,50326092,0.129433098,0.999885
no,TO.BO.LC4.M.5,Boston,3721042,0,413,3720629,50326092,0.073938624,0.999889
no,TO.BO.R2.U.2,Boston,17484126,0,2047,17482079,70134999,0.249292454,0.999883
no,TO.BO.R4.U.1,Boston,3835200,0,448,3834752,70134999,0.054683112,0.999883
no,TO.BO.R4.U.2,Boston,7689748,0,921,7688827,70134999,0.109642092,0.99988
no,TO.BO.R4.U.3,Boston,11368366,0,1265,11367101,70134999,0.162092624,0.999888726
no,TO.BO.R4.U.4,Boston,1505730,0,190,1505540,70134999,0.021469024,0.999873815
no,TO.BO.R4.U.5,Boston,10365904,0,1256,10364648,70134999,0.147799303,0.999878834
no,TO.BO.WL1.M.2,Boston,17951934,0,2045,1794988,50326092,0.35671226,0.099989
no,TO.BO.WL1.M.3,Boston,12127358,0,1414,12125944,54745569,0.221522184,0.999883
no,TO.BO.WL1.M.4,Boston,15091486,0,1727,15089759,54745569,0.27566589,0.999886
no,TO.BO.WL1.M.5,Boston,1489450,0,191,1489259,54745569,0.027206768,0.999872
no,TO.BO.WL2.M.1,Boston,9196146,0,1057,9195089,54745569,0.167979732,0.999885
no,TO.BO.WL2.M.3,Boston,8266392,0,949,8265443,54745569,0.150996549,0.999885
no,TO.BO.WL3.M.1,Boston,7912202,0,891,7911311,54745569,0.144526802,0.999887
no,TO.BO.WL3.M.2,Boston,5982370,0,663,5981707,51207283,0.116826546,0.999889
no,TO.BO.WL3.M.3,Boston,7231558,0,802,7230756,51207283,0.141221279,0.999889
no,TO.BO.WL3.M.4,Boston,3263934,0,390,3263544,51207283,0.063739644,0.999881
no,TO.BO.WL3.M.5,Boston,14152160,0,1633,14150527,51207283,0.276370062,0.999885
no,TO.BO.WL4.M.1,Boston,14002550,0,1658,14000892,51207283,0.273448408,0.999882
no,TO.BO.WL4.M.2,Boston,1315882,0,147,1315735,51207283,0.025697165,0.999888
no,TO.BO.WL4.M.3,Boston,4463098,0,523,4462575,51207283,0.087157485,0.999883
no,TO.BO.WL4.M.5,Boston,13213682,0,1480,13212202,52866544,0.249944123,0.999888
no,TO.LA.COM.M.1,Los Angeles,3811320,0,479,3810841,68783787,0.055410151,0.999874322
no,TO.LA.COM.M.2,Los Angeles,1004704,0,137,1004567,68783787,0.014606698,0.999863641
no,TO.LA.COM.M.3,Los Angeles,7506868,0,887,7505981,68783787,0.109137172,0.999881842
no,TO.LA.COM.M.4,Los Angeles,14830038,0,1788,14828250,70167322,0.211352487,0.999879
no,TO.LA.GLO.M.2,Los Angeles,1364180,0,167,1364013,93470629,0.014594745,0.999878
no,TO.LA.GLO.M.5,Los Angeles,3230532,0,329,3230203,93470629,0.034562001,0.999898
no,TO.LA.HAR.M.4,Los Angeles,1390196,0,148,1390048,53545784,0.025962754,0.999894
no,TO.LA.MR1.M.1,Los Angeles,10628250,0,1215,10627035,61417779,0.173048426,0.999886
no,TO.LA.MR1.M.2,Los Angeles,7132820,0,841,7131979,61417779,0.116136078,0.999882
no,TO.LA.MR1.M.3,Los Angeles,10065214,0,1095,10064119,61417779,0.163881113,0.999891
no,TO.LA.MR1.M.4,Los Angeles,9479678,0,1163,9478515,61417779,0.154347457,0.999877
no,TO.LA.NWH.M.1,Los Angeles,3437878,0,409,3437469,86827234,0.039594466,0.999881
no,TO.LA.NWH.M.3,Los Angeles,2705894,0,315,2705579,86827234,0.031164116,0.999884
no,TO.LA.NWH.M.4,Los Angeles,3473790,0,402,3473388,86827234,0.040008069,0.999884
no,TO.LA.PEP.M.1,Los Angeles,9366482,0,1078,9365404,68783787,0.136172816,0.999885
no,TO.LA.PEP.M.3,Los Angeles,6214776,0,683,6214093,68783787,0.090352338,0.99989
no,TO.LA.PEP.M.5,Los Angeles,11111582,0,1243,11110339,68783787,0.161543621,0.999888
no,TO.LA.RID.M.1,Los Angeles,8225128,0,936,8224192,54447850,0.15106433,0.999886
no,TO.LA.ROS.M.1,Los Angeles,3308910,0,353,3308557,59636458,0.055484684,0.999893
no,TO.LA.ROS.M.3,Los Angeles,1116284,0,134,1116150,59636458,0.018718147,0.99988
no,TO.LA.STC.M.3,Los Angeles,13794690,0,1630,13793060,68783787,0.200551476,0.999882
no,TO.LA.STC.M.5,Los Angeles,14325718,0,1593,14324125,68783787,0.208271725,0.999889
no,TO.LA.VNS.M.2,Los Angeles,2232970,0,272,2232698,55010486,0.040591716,0.999878
no,TO.LA.VNS.M.3,Los Angeles,2657008,0,289,2656719,55010486,0.048300028,0.999891
no,TO.LA.VNS.M.5,Los Angeles,1879556,0,200,1879356,55010486,0.034167231,0.999894
no,TO.LA.WHI.M.5,Los Angeles,2535436,0,300,2535136,59160971,0.042856565,0.999882
no,TO.LA.ZOO.M.1,Los Angeles,9965098,0,1162,9963936,86717338,0.114914713,0.999883
no,TO.LA.ZOO.M.3,Los Angeles,6522598,0,745,6521853,86717338,0.075216769,0.999886
no,TO.LA.ZOO.M.6,Los Angeles,8476140,0,926,8475214,86717338,0.097744467,0.999890752
no,TO.MN.L01-TO.PA.M.1,Minneapolis,9442448,0,1061,9441387,63510389,0.148675644,0.999888
no,TO.MN.L01-TO.PA.M.3,Minneapolis,11005978,0,1274,11004704,63510389,0.173294136,0.999884
no,TO.MN.L01-TO.PA.M.4,Minneapolis,6096346,0,647,6095699,63510389,0.095989744,0.999894
no,TO.MN.L01-TO.PA.M.5,Minneapolis,1301362,0,165,1301197,63510389,0.020490537,0.999873
no,TO.MN.L01-TO.U.2,Minneapolis,9016616,0,1078,9015538,47328283,0.190512214,0.99988
no,TO.MN.L01-TO.U.4,Minneapolis,7668954,0,842,7668112,47328283,0.162037444,0.99989
no,TO.MN.L01-TO.U.5,Minneapolis,11277784,0,1345,11276439,46686946,0.241561828,0.999881
no,TO.MN.L02-TO.M.1,Minneapolis,4467786,0,477,4467309,63510389,0.070347325,0.999893
no,TO.MN.L02-TO.M.3,Minneapolis,12511734,0,1428,12510306,63510389,0.19700295,0.999886
no,TO.MN.L02-TO.M.4,Minneapolis,5166492,0,619,5165873,63510389,0.08134877,0.999880189
no,TO.MN.L02-TO.U.1,Minneapolis,3483200,0,414,3482786,46686946,0.074607579,0.999881
no,TO.MN.L02-TO.U.2,Minneapolis,2476856,0,244,2476612,46686946,0.053052431,0.999901
no,TO.MN.L02-TO.U.3,Minneapolis,15315270,0,1707,15313563,46686946,0.328041804,0.999889
no,TO.MN.L02-TO.U.4,Minneapolis,12545814,0,1431,12544383,46686946,0.268722096,0.999886
no,TO.MN.L03-TO.M.1,Minneapolis,11792600,0,1337,11791263,63510389,0.185679858,0.999886624
no,TO.MN.L03-TO.M.2,Minneapolis,11549106,0,1329,11547777,74214912,0.155617054,0.999885
no,TO.MN.L03-TO.M.4,Minneapolis,6012370,0,700,6011670,74214912,0.081012964,0.999884
no,TO.MN.L03-TO.U.3,Minneapolis,1095344,0,106,1095238,60238573,0.018183432,0.999903
no,TO.MN.L03-TO.U.4,Minneapolis,11995868,0,1371,11994497,60238573,0.199139312,0.999886
no,TO.MN.L03-TO.U.5,Minneapolis,3222500,0,365,3222135,60238573,0.053495623,0.999887
no,TO.MN.L04-TO.M.2,Minneapolis,6400016,0,726,6399290,74214912,0.086236254,0.999887
no,TO.MN.L04-TO.M.4,Minneapolis,11963336,0,1333,11962003,74214912,0.161198547,0.999889
no,TO.MN.L04-TO.M.5,Minneapolis,15806418,0,1839,15804579,74214912,0.212981698,0.999884
no,TO.MN.L04-TO.U.1,Minneapolis,13901700,0,1563,13900137,60238573,0.230777379,0.999888
no,TO.MN.L04-TO.U.3,Minneapolis,13940812,0,1521,13939291,60238573,0.231426664,0.999891
no,TO.MN.L04-TO.U.5,Minneapolis,14730946,0,1749,14729197,60238573,0.244543409,0.999881
no,TO.MN.L05-TO.M.1,Minneapolis,2641326,0,305,2641021,74214912,0.035590233,0.999884528
no,TO.MN.L05-TO.M.2,Minneapolis,1960850,0,238,1960612,74214912,0.02642124,0.999878624
no,TO.MN.L05-TO.M.3,Minneapolis,16015972,0,1840,16014132,74214912,0.215805309,0.999885115
no,TO.MN.L05-TO.M.5,Minneapolis,6622416,0,803,6621613,70726224,0.093634519,0.999879
no,TO.MN.L05-TO.U.1,Minneapolis,6136964,0,694,6136270,49736498,0.123389548,0.999887
no,TO.MN.L05-TO.U.2,Minneapolis,18316690,0,2065,18314625,49736498,0.368274622,0.999887
no,TO.MN.L05-TO.U.3,Minneapolis,2960012,0,371,2959641,49736498,0.059513881,0.999875
no,TO.MN.L05-TO.U.4,Minneapolis,7333284,0,769,7332515,49736498,0.147442709,0.999895
no,TO.MN.L05-TO.U.5,Minneapolis,12523708,0,1413,12522295,49736498,0.251801162,0.999887
no,TO.MN.L06-TO.M.2,Minneapolis,12550716,0,1439,12549277,70726224,0.177454914,0.999885
no,TO.MN.L06-TO.M.3,Minneapolis,13818816,0,1574,13817242,70726224,0.195384614,0.999886
no,TO.MN.L06-TO.M.5,Minneapolis,4293244,0,493,4292751,70726224,0.060702293,0.999885
no,TO.MN.L06-TO.U.2,Minneapolis,1107610,0,116,1107494,49736498,0.022269561,0.999895
no,TO.MN.L06-TO.U.3,Minneapolis,1005202,0,134,1005068,49736498,0.02021055,0.999867
no,TO.MN.L06-TO.U.4,Minneapolis,13591870,0,1476,13590394,54934827,0.247418091,0.999891
no,TO.MN.L06-TO.U.5,Minneapolis,17415516,0,1958,17413558,54934827,0.317021404,0.999888
no,TO.MN.L07-TO.M.2,Minneapolis,7996864,0,824,7996040,70726224,0.113067877,0.999897
no,TO.MN.L07-TO.M.3,Minneapolis,4800338,0,515,4799823,70726224,0.067872109,0.999892716
no,TO.MN.L07-TO.M.4,Minneapolis,1492164,0,142,1492022,70726224,0.021097747,0.999904836
no,TO.MN.L07-TO.M.5,Minneapolis,16951026,0,1968,16949058,70726224,0.239671017,0.999883901
no,TO.MN.L07-TO.U.1,Minneapolis,1951704,0,233,1951471,54934827,0.035527626,0.999881
no,TO.MN.L07-TO.U.2,Minneapolis,6679990,0,744,6679246,54934827,0.121598453,0.999889
no,TO.MN.L07-TO.U.3,Minneapolis,13236246,0,1564,13234682,54934827,0.240944529,0.999882
no,TO.MN.L07-TO.U.5,Minneapolis,1122062,0,104,1121958,54934827,0.020425331,0.999907
no,TO.MN.L08-TO.M.1,Minneapolis,2188510,0,261,2188249,75745737,0.028892847,0.999881
no,TO.MN.L08-TO.M.2,Minneapolis,20121546,0,2414,20119132,75745737,0.26564592,0.99988
no,TO.MN.L08-TO.M.4,Minneapolis,15894760,0,1763,15892997,75745737,0.209843625,0.999889
no,TO.MN.L08-TO.M.5,Minneapolis,25611376,0,2990,25608386,75745737,0.338123002,0.999883
no,TO.MN.L08-TO.U.2,Minneapolis,10419658,0,1193,10418465,46993313,0.221726398,0.999886
no,TO.MN.L08-TO.U.3,Minneapolis,13089916,0,1491,13088425,46993313,0.278548482,0.999886
no,TO.MN.L08-TO.U.4,Minneapolis,4881806,0,574,4881232,46993313,0.103882993,0.999882
no,TO.MN.L08-TO.U.5,Minneapolis,8300170,0,1046,8299124,46993313,0.176624491,0.999874
no,TO.MN.L09-TO.M.1,Minneapolis,1754316,0,182,1754134,75745737,0.023160591,0.999896
no,TO.MN.L09-TO.M.2,Minneapolis,8957738,0,1054,8956684,75745737,0.118260622,0.999882
no,TO.MN.L09-TO.M.4,Minneapolis,17598308,0,2021,17596287,60676252,0.290036174,0.999885
no,TO.MN.L09-TO.M.5,Minneapolis,2173306,0,274,2173032,60676252,0.035818066,0.999874
no,TO.MN.L09-TO.U.2,Minneapolis,3910774,0,489,3910285,46993313,0.083219798,0.999875
no,TO.MN.L09-TO.U.4,Minneapolis,5903130,0,651,5902479,46993313,0.125616383,0.99989
no,TO.MN.L09-TO.U.5,Minneapolis,6749864,0,826,6749038,58700599,0.114987992,0.999878
no,TO.MN.L10-TO.M.1,Minneapolis,4093890,0,439,4093451,60676252,0.067471043,0.999893
no,TO.MN.L10-TO.M.3,Minneapolis,1447624,0,177,1447447,60676252,0.023858164,0.999878
no,TO.MN.L10-TO.M.4,Minneapolis,17327128,0,1996,17325132,60676252,0.28556688,0.999885
no,TO.MN.L10-TO.U.1,Minneapolis,9944060,0,1131,9942929,58700599,0.169403041,0.999886
no,TO.MN.L10-TO.U.2,Minneapolis,6842082,0,750,6841332,58700599,0.116558981,0.99989
no,TO.MN.L10-TO.U.3,Minneapolis,18428650,0,2132,18426518,58700599,0.313943134,0.999884
no,TO.MN.L10-TO.U.4,Minneapolis,14242180,0,1591,14240589,58700599,0.2426241,0.999888
no,TO.MN.L11-TO.M.1,Minneapolis,16598516,0,1864,16596652,60676252,0.27355869,0.999888
no,TO.MN.L11-TO.M.2,Minneapolis,10364210,0,1149,10363061,47328283,0.218985548,0.999889
no,TO.MN.L11-TO.M.3,Minneapolis,7647650,0,970,7646680,47328283,0.161587311,0.999873
no,TO.MN.L11-TO.M.5,Minneapolis,10839386,0,1233,10838153,47328283,0.229025549,0.999886
no,TO.MN.L11-TO.U.1,Minneapolis,1441460,0,146,1441314,58700599,0.024556138,0.999899
no,TO.MN.L11-TO.U.3,Minneapolis,2313548,0,241,2313307,61748404,0.037467333,0.999896
no,TO.MN.L11-TO.U.4,Minneapolis,1477616,0,185,1477431,61748404,0.023929623,0.999875
no,TO.PX.ALA.M.2,Phoenix,4908576,0,505,4908071,61258063,0.080129468,0.999897
no,TO.PX.ALA.M.3,Phoenix,1243822,0,132,1243690,61258063,0.020304625,0.999894
no,TO.PX.ALA.M.4,Phoenix,1104504,0,112,1104392,55300858,0.019972638,0.999899
no,TO.PX.ALA.M.5,Phoenix,3265162,0,371,3264791,55300858,0.059043605,0.999886
no,TO.PX.BUF.M.1,Phoenix,2610398,0,326,2610072,86112066,0.030313963,0.999875
no,TO.PX.BUF.M.2,Phoenix,1144160,0,131,1144029,86112066,0.013286872,0.999885506
no,TO.PX.CLA.M.1,Phoenix,1061544,0,116,1061428,59017095,0.01798706,0.999891
no,TO.PX.COY.M.1,Phoenix,9174674,0,1050,9173624,51854414,0.176931399,0.999886
no,TO.PX.COY.M.3,Phoenix,1021824,0,107,1021717,51854414,0.019705632,0.999895
no,TO.PX.COY.M.6,Phoenix,8483120,0,957,8482163,51854414,0.163594945,0.999887
no,TO.PX.DF1.M.1,Phoenix,1986342,0,250,1986092,57477616,0.034558531,0.999874
no,TO.PX.DF2.M.1,Phoenix,1778896,0,182,1778714,55672462,0.031952889,0.999898
no,TO.PX.LAP.M.3,Phoenix,1153754,0,171,1153583,60904779,0.018943571,0.999852
no,TO.PX.LAP.M.4,Phoenix,5296114,0,653,5295461,60904779,0.086957281,0.999877
no,TO.PX.WES.M.1,Phoenix,4349824,0,513,4349311,57423880,0.075749392,0.999882
no,TO.PX.WES.M.2,Phoenix,11830880,0,1452,11829428,57423880,0.206027179,0.999877